㯷	㯷 柚
㳽	㳽 满
个	个 的
乃	乃 那
光	光 亮
刺	刺 刺
华	华 还
呃	呃 骗
咒	咒 骂
奀	奀 小
婎	婎 美
将	将 把
扭	扭 拧
拐	拐 抱
掂	掂 端
揣	揣 猜
摣	摣 拿
无	无 不
杰	杰 段
死	死 极
甕	甕 缸
畏	畏 秽
皿	皿 血
睇	睇 看
睏	睏 睡
瞄	瞄 看
瞓	瞓 睡
簎	簎 刺
胒	胒 些
艃	艃 帆
莫	莫 别
菢	菢 孵
话	话 说
踎	踎 蹲
都	都 了
镬	镬 锅
颠	颠 傻
𫠲	𫠲 直
㑢	㑢 他们
㑷	㑷 那么
㓤	㓤 刺扎
㓥	㓥 宰杀
䈾	䈾 横打
䞌	䞌 亏本
仔	仔 儿子
仙	仙 铜板
任	任 任由
伢	伢 婴儿
值	值 值得
偌	偌 你们
偔	偔 我们
克	克 绳结
净	净 干净
几	几 多么
剢	剢 剁切
吽	吽 蠢笨
呕	呕 呕吐
哏	哏 刚刚
唛	唛 商标
嗽	嗽 咳嗽
嘢	嘢 东西
垌	垌 田野
埕	埕 坛子
声	声 声音
奶	奶 母亲
妗	妗 舅母
姆	姆 伯母
尺	尺 尺子
尾	尾 尾巴
席	席 席子
底	底 底下
弹	弹 挑剔
彩	彩 幸运
悭	悭 节俭
懵	懵 舞动
扪	扪 遮盖
找	找 兑换
押	押 强迫
捂	捂 推搡
掼	掼 扔掉
揰	揰 碰撞
揾	揾 找寻
攰	攰 疲乏
斫	斫 剁切
未	未 没有
杯	杯 杯子
枧	枧 肥皂
样	样 样子
档	档 摊子
毽	毽 毽子
氹	氹 水洼
浅	浅 讽刺
涂	涂 涂上
渡	渡 渡船
湿	湿 肝脏
漏	漏 遗失
疲	疲 拖延
眯	眯 闭眼
瞠	瞠 张开
破	破 劈开
碌	碌 翻滚
禁	禁 耐用
种	种 种子
索	索 绳子
绸	绸 绸子
缚	缚 捆绑
翳	翳 伤心
脷	脷 舌头
蒟	蒟 蒟蒻
蚝	蚝 牡蛎
蛤	蛤 青蛙
蜢	蜢 蚱蜢
蠘	蠘 花蟹
衰	衰 倒霉
袜	袜 袜子
誓	誓 诅咒
谂	谂 思考
谷	谷 谷子
趠	趠 跳跃
跌	跌 摔跤
跷	跷 凑巧
轿	轿 轿子
辘	辘 车轮
鑑	鑑 间隔
钦	钦 恭敬
镜	镜 镜子
雁	雁 大雁
靓	靓 漂亮
韫	韫 困住
须	须 胡子
馟	馟 气味
鲎	鲎 鳖鱼
鹤	鹤 白鹤
鼻	鼻 鼻子
𠱓	𠱓 央求
𠵴	𠵴 什么
𩠌	𩠌 菜肴
𫐥	𫐥 游荡
𫖵	𫖵 昂头
𫣶	𫣶 依靠
𰗦	𰗦 阁楼
挹	挹 ①用5个手指靠拢抓住②量词
㶶	㶶 糊、焦
侧	侧 使倾斜
共	共 抱孩子
冧	冧 塌下来
卯	卯 坏家伙
咪	咪 麦克风
喏	喏 你们的
嗗	嗗 吞咽声
嬲	嬲 怒、恨
得	得 准、能
扻	扻 碰、撞
拭	拭 擦、抹
掕	掕 大力拉
搀	搀 用棍刺
瘪	瘪 不饱满
筲	筲 缚、拴
篢	篢 大箱子
糁	糁 小米粒
绹	绹 缚、拴
缄	缄 封、闭
罨	罨 敷上去
群	群 随伴着
腩	腩 腹下肉
腯	腯 肥极了
葭	葭 露兜树
趏	趏 趟、次
难	难 不容易
𪜃	𪜃 怎么样
恶	恶 ①凶②.生气③难
临	临 阵、会儿
似	似 像、好像
佬	佬 成年男人
僭	僭 进、加进
去	去 表示夸张
呿	呿 表示鄙视
喊	喊 叫、名叫
嗦	嗦 用嘴吸取
增	增 拔、拉长
扱	扱 放进缝中
拣	拣 选择、挑
挦	挦 ①拔②插
擗	擗 扔、丢掉
春	春 卵、阴囊
樽	樽 长颈瓶子
淈	淈 稠、不稀
渧	渧 液体滴下
潺	潺 胶液状物
煀	煀 用浓烟熏
煲	煲 用煲来煮
牸	牸 雌性牲口
猎	猎 贪食、馋
畀	畀 ①给②被
瞌	瞌 点的动作
篷	篷 液体外溢
缭	缭 手工缝衣
肭	肭 很肥很胖
腰	腰 肾、腰子
证	证 对质做证
谛	谛 笨、糊涂
趘	趘 尾随偷窥
跣	跣 跺，顿足
踏	踏 ①穿②戴
蹬	蹬 腿往下蹬
麬	麬 黏性很强
𨂾	𨂾 举步、跨
𨆓	𨆓 往高处爬
字	字 ①文字②5分钟也叫“一个字”
㗷	㗷 全、都、完
俼	俼 别人、人家
其	其 他、她、它
冚	冚 动词“盖”
凹	凹 低陷的地方
厅	厅 正房、客厅
听	听 等候、等待
嘱	嘱 嘱咐、吩咐
壅	壅 填埋、培土
子	子 束、线一绺
孽	孽 诙谐、幽默
安	安 编造、捏造
屋	屋 ①房子②家
岌	岌 不稳而动摇
忆	忆 回忆、记忆
性	性 ①脾气②锈
怼	怼 用拳推出去
抄	抄 搜查、寻找
捋	捋 骗取、骗走
捰	捰 拿、取、要
掿	掿 玩弄、玩耍
揤	揤 ①找②擦拭
撩	撩 ①戏弄②惹
擞	擞 摇动、抖动
斗	斗 戏弄、逗乐
日	日 （时间）天
旦	旦 大戏的女角
曳	曳 不好、差劲
梗	梗 一定、必定
棚	棚 蔓延、攀缘
歇	歇 休息、歇息
油	油 涂、油、染
浆	浆 糨糊、香糊
清	清 ①稀②不浊
烙	烙 在锅里干炒
爽	爽 快感、爽快
班	班 量词“群”
琴	琴 量词“片”
痹	痹 发麻的感觉
瘼	瘼 眼睛起薄膜
直	直 爽直、忠直
睄	睄 用眼睛一瞥
碎	碎 末子、碎片
窗	窗 窗户、窗子
粉	粉 粉末、面儿
精	精 机灵、聪敏
羹	羹 汤勺、羹匙
肚	肚 ①腹部②胃
腍	腍 松软不坚实
艾	艾 艾草的一种
苶	苶 枯萎、干枯
讲	讲 说、谈、讲
说	说 教唆、说服
趣	趣 ①有趣②挤
部	部 ①本②本子
镊	镊 用夹子捏住
间	间 房间、屋子
鞠	鞠 体内加压力
项	项 雌性小禽畜
𠯋	𠯋 不好、差劲
𠱂	𠱂 搁、放、存
𠹌	𠹌 那样、那么
𢗉	𢗉 害怕、吃惊
𧨾	𧨾 ①欺骗②哄
𫱝	𫱝 妾、小老婆
𰪪	𰪪 糕饼的通称
㗁	㗁 我的或我们的
㷫	㷫 用微火烘东西
冇	冇 ①没有②没有
叹	叹 ①称赞②享受
吊	吊 ①悬挂②打汲
呻	呻 ①呻吟②念叨
命	命 ①命运②生命
唞	唞 ①休息②解开
善	善 死（忌讳语）
喼	喼 手提的扁箱子
嚡	嚡 ①不平滑②痒
壳	壳 ①勺儿②外壳
妒	妒 用话语嘲弄人
废	废 没用，骂人语
影	影 ①影子②影射
恒	恒 植物种子饱满
恤	恤 （借字）强迫
扽	扽 猛然用力一拉
抽	抽 双手提起东西
数	数 ①骂人②计算
朝	朝 ①早饭②早上
林	林 草丛、小树丛
泡	泡 ①泡沫②冲淡
洞	洞 莽撞地走进去
爱	爱 ①将要②亲爱
眼	眼 ①眼睛②小孔
窜	窜 气味有刺激性
簏	簏 家畜住的地方
簕	簕 ①骨刺②荆棘
粗	粗 粗糙、不精细
粪	粪 屎、尿等肥料
耷	耷 物体弯曲向下
行	行 走，慢步前进
衲	衲 夹衣，棉内衣
识	识 认识、懂、知
踭	踭 脚跟或胳臂弯
逳	逳 ①动②碰、弄
链	链 ①发条②链条
颓	颓 笨，没有手艺
饮	饮 ①大米汤②喝
𠕳	𠕳 用勺子舀液体
𠳞	𠳞 他的、他们的
𢱑	𢱑 用手抓挖东西
𢲈	𢲈 阻住不使移动
㓷	㓷 ①咬②来回割切
丑	丑 ①样子难看②羞
凝	凝 ①遇冷凝结②澄
噏	噏 口腔不断地开合
嚣	嚣 刻薄，气焰嚣张
岩	岩 很靠边缘的状态
崇	崇 缩头缩脑的状态
崩	崩 器物缺了一个口
手	手 肩膀以下全叫手
拧	拧 ①拿、拈②转动
搪	搪 拨开糊状的东西
摐	摐 用拳或棍棒直击
擘	擘 ①张开②剥、掰
梇	梇 门闸的粗木或铁
椊	椊 ①塞、挡②塞子
江	江 帮、群（量词）
沓	沓 ①叠起来②量词
浓	浓 生长茂盛的状态
涌	涌 海潮可通的河沟
滚	滚 ①沸、开②翻滚
潲	潲 洗米水、刷锅水
瓯	瓯 较深、较大的碗
皲	皲 手脚冻裂的小缝
糍	糍 糯米粉做的饼食
纳	纳 勾连起来，勾搭
绥	绥 布边破烂不整齐
缗	缗 元（货币计量）
耕	耕 ①山岭间②梯级
聂	聂 盖得很严，没缝
胀	胀 ①饱、涨满②憋
茜	茜 金鱼水草的一种
莍	莍 计算丛生的东西
落	落 ①下②中饱私囊
蒲	蒲 ①浮在水面②起
蚌	蚌 淡水贝类的一种
轮	轮 火蔓延叫“轮”
鎅	鎅 锯、割、切、裁
雷	雷 摔跤时头部先下
霉	霉 腐烂的、发霉的
飒	飒 放人洞中或缝中
饭	饭 大米煮成的干饭
𡌶	𡌶 泥浆，同“湴”
𢯭	𢯭 ①看管②和、跟
㨂	㨂 用棍状物尖端直捣
䠥	䠥 跛、瘸，同“尯”
倾	倾 ①倒在一起②闲谈
兵	兵 大力把身体挤进去
垅	垅 平地高起的长土堆
垽	垽 水里污积物或油积
天	天 天空、上空、青天
好	好 ①很②喜欢，爱好
当	当 ①典当、押②当作
扤	扤 ①按、摁②向、照
挢	挢 横着抹、拭汗或水
掹	掹 扳，往下或往里拉
揞	揞 用手掌捂住、盖住
揿	揿 ①按压、按下②压
摷	摷 捉鱼虾水产的网兜
擳	擳 搔、挠以使人发笑
晏	晏 ①午饭②不早、迟
晚	晚 ①晚上②晚饭③迟
涮	涮 ①洗刷②打③批评
溜	溜 引诱、诱惑、招惹
炊	炊 与“蒸”是同义词
烘	烘 ①热②发火、发怒
焙	焙 放在炉火旁边烘烤
爆	爆 ①炸②裂开③公开
爪	爪 ①用爪扒物②爪子
牛	牛 引申义是蛮不讲理
猪	猪 未成熟的雌性小猪
甜	甜 ①糖味②鲜美，鲜
窿	窿 洞，也写作“䆔”
细	细 小，相对于“大”
绒	绒 呢子、毛料纺织品
续	续 ①找补钱②接起来
翼	翼 ①翅膀②鲨鱼的鳍
脌	脌 ①乳房②乳汁、奶
芊	芊 芋头旁边的小芋头
虚	虚 血气亏损叫“虚”
蚶	蚶 丝蚶、毛蚶等贝类
衫	衫 上衣和裤子，衣服
装	装 ①偷窥②载③假装
襻	襻 ①蔓延②横的布带
躀	躀 ①跌②用手掌横击
连	连 ①缝②相连、连接
阔	阔 ①宽、宽广②阔气
面	面 ①脸②面条、面粉
颈	颈 ①脖子②代表性格
𢆡	𢆡 ①乳房②乳汁、奶
𢩦	𢩦 搔、挠以使人发笑
傤	傤 一船货叫“一儎货”
吐	吐 倒，从器物中倒出来
啜	啜 ①吸食果子瓤②接吻
啱	啱 ①正确②适合③相好
喉	喉 ①喉咙、喉头②管子
噷	噷 表示愤恨，不以为然
墣	墣 田里用犁翻起的土块
墱	墱 阶梯一级叫“一墱”
实	实 ①十分、的确②一定
山	山 ①坟墓②山林③山岭
批	批 ①猜测②租赁、租用
抵	抵 ①活该②合算、值得
挞	挞 ①欠债不还②露出来
挼	挼 两掌或两指搓揉、捻
掯	掯 ①有能力②凶、好斗
揈	揈 向下挥手摆动，甩手
揽	揽 ①拥抱②提起来，拔
搅	搅 ①搅动②玩耍、戏弄
撚	撚 用大拇指、食指搓动
擸	擸 ①用双手抱住②量词
栏	栏 毛线，也写作“唥”
燅	燅 放在火上烘干、烤干
狼	狼 ①兽名②勇猛、凶狠
碟	碟 ①盘子②用大刀砍削
礼	礼 ①礼节②礼貌③斜看
秋	秋 立秋或其前后的时间
笠	笠 ①竹签，框子②罩住
箦	箦 较高的箱子，今少用
糟	糟 ①糟蹋②指酒糟的糟
肥	肥 ①肥②胖③土地肥沃
脚	脚 大小腿和脚丫的合称
郁	郁 内心不舒畅，有委屈
飙	飙 ①疾驰、狂奔②冒出
𪥕	𪥕 钝、不尖锐、不锋利
䦁	䦁 很宽、很薄的一种铁锄
企	企 ①站立②笔画中的竖笔
侉	侉 外地人说本地话音不正
啖	啖 如“一啖”即“一口”
嗳	嗳 胃纳过多，食物吐出来
姣	姣 ①女人性欲发作②浪荡
学	学 ①像、好像②学习、学
宰	宰 用手指钳住肉扭转过来
平	平 ①便宜②平坦③使之平
挽	挽 ①藏在怀中②卷起、挽
掉	掉 遭、趟，如“走一掉”
摼	摼 ①敲、槌②额部突出貌
散	散 中医术语，发散、破败
湇	湇 器内液体因摇动而外溢
炙	炙 在燃烧着的炭灰中烧熟
田	田 耕地中有水的，如稻田
缆	缆 大绳子，多指船上用的
膥	膥 ①卵②阳性动物的阴囊
螆	螆 虾子般小的有害的昆虫
褪	褪 ①解衣服②后延，后退
败	败 ①破产②败坏（名声）
采	采 在，是“在”字的音变
钻	钻 ①穿孔洞的用具②钻石
锹	锹 ①锨，铲土的工具②铲
𨳍	𨳍 （借字）男性外生殖器
乜	乜 ①或者、或、还是②什么
伞	伞 袖伞或皇帝出游用的大伞
储	储 储蓄、积累，如“储钱”
兴	兴 ①开始创办②时兴、时髦
吃	吃 ①吃②喝③吸、抽（烟）
嗒	嗒 ①嗒嘴②放在舌面慢慢吃
应	应 ①再②已经③回答、搭腔
扇	扇 ①扇子②打③平薄地切削
拗	拗 ①弯折②横蛮地争辩③睡
改	改 这里，是“该”字的音变
激	激 激动、气、生气、使生气
相	相 ①机灵②讥讽③喜欢挑剔
睺	睺 对着看，围观。粘着不走
纰	纰 绳子或衣服擦损了一部分
缿	缿 破烂的瓦器或瓦器的碎片
袭	袭 双手把物按住，不使移动
载	载 ①盛②装载、记载、登载
较	较 ①对比、较量②兑③合页
迳	迳 纵横交织起来的纱线或丝
酬	酬 用牺牲祭品向神表示谢意
钵	钵 陶制器具，高身盘的一种
闩	闩 ①被物勾住②门闩③关闭
陂	陂 石头水坝，又叫“陂头”
鸡	鸡 ①哨子②妓女③枪的扳机
𡰪	𡰪 器物的底部或房屋的角落
𢲲	𢲲 用横放的木棍架住，盛住
𬉼	𬉼 烧柴火、垃圾，不使猛燃
䆔	䆔 弯下腰来，如“审紧插秧”
佮	佮 ①接合、套上②对等地顶数
儑	儑 呆，精神不振作，疲乏不堪
匎	匎 ①浪费掉了②（植物）倒伏
匿	匿 ①不加柴，用慢火煮②躲藏
叮	叮 ①扎进去②螫，如蜜蜂叮人
味	味 ①气味②味道③代替“盐”
引	引 ①植物嫩芽②鞭炮的引火线
执	执 ①收拾②检、拾③抓④生养
拂	拂 ①兽类的尾左右摆动②挥水
拱	拱 ①这样②建筑物有弧的地方
朒	朒 肥，小孩很胖叫“肥朒朒”
杛	杛 一根大树枝叫“一杛树枝”
歹	歹 ①猫屎、猪尿的臭味②吝啬
泑	泑 釉，瓦器外面有光泽的一层
益	益 ①益处，利益②使得到益处
真	真 ①清楚、明显②真正、不假
肫	肫 ①不机灵、傻气②禽类的胃
覆	覆 ①猜疑②把容器反过来放置
边	边 哪儿、哪。与“边处”同义
麸	麸 花生、黄豆等炸油后的渣子
䋎	䋎 缝衣服时用线很稀疏地缝一下
伏	伏 ①躲藏②把头伏在臂上或桌上
冻	冻 冷。涧、冻、冷程度依次增加
咸	咸 ①与“盐”是同义词②指味道
地	地 水田以外的耕地、土地、地面
愀	愀 突然头晕失去知觉叫“着愀”
戆	戆 ①笨、不敏感、不讲理②傻癫
抔	抔 ①摇（手）、挥（手）②拨开
燥	燥 ①干、不润，燥热②性情暴躁
猛	猛 ①有权势、有地位②火势旺盛
皱	皱 平滑的衣物、纸张变成有皱纹
筹	筹 计算搬运工作量的木片、竹片
绲	绲 在衣服边缘加花边叫“绲边”
胲	胲 鸟等禽类的嗪囊，如“鸡胲”
荡	荡 游荡、逛，如“其至好去荡”
菜	菜 青菜，专指青菜，不包括肉类
铎	铎 ①啄②棍状物末端特别大的地
霜	霜 微冷，像早晨接触霜时的感觉
𢯎	𢯎 搔，如“我𢯎痒”（我搔痒）
𪮶	𪮶 从上面一点点滴下来，类似淋
劙	劙 ①用刀来回割切②薄物嵌入缝中
勃	勃 ①横打、横扫②流浪，无事可做
忍	忍 ①憋着大小便不拉②容忍、忍让
擤	擤 ①擤鼻涕②用钱大方叫“大擤”
炕	炕 把食品放锅里用文火炒干、烘干
煠	煠 放在大锅里加大量水用大火烧煮
甩	甩 ①逃脱，脱开②不留神陷到坑里
铲	铲 ①铁锨②用铲铲土或起土的动作
铺	铺 ①商店②十华里路叫“一铺路”
闸	闸 ①街道或小巷防盗的门棚②水闸
驶	驶 ①航行②使唤③用，如“驶钱”
骾	骾 喉头有鱼刺之类的东西不能咽下
𠺘	𠺘 把水放在器皿（或口腔内）摇动
𪖐	𪖐 嘴角向上弯，瞧不起人时的嘴型
㓟	㓟 ①用小刀削东西②批评③使劲学习
㧻	㧻 用尖的、较小的工具或棍棒刺东西
厾	厾 用尖的、较小的工具或棍棒刺东西
扎	扎 ①捆、缚②受惊而不自主地跳起来
栟	栟 旧式床的围栏或椅子的扶手的地方
楞	楞 ①瓣，量词②半边、半个、一部分
槽	槽 用好饲料喂牲口，使之快点肥起来
毒	毒 ①各啬，不肯给人家东西②心肠坏
水	水 ①水②雨③赌场收的税也叫“水”
没	没 ①潜水②隐匿别人的东西据为已有
泥	泥 ①土②用泥涂上或堵塞③使用浪费
焗	焗 ①罩住让器内焖热②罩住使之窒息
白	白 ①白色②直白、露骨③海蚌的一种
碑	碑 墙壁叫“墙碑”，壁顶叫“碑尾”
禾	禾 ①成熟到快要烂的状态②事情糟了
穿	穿 ①破成洞②里面的东西流出或露出
迄	迄 ①小便不由自主叫“迄尿”②留下
䘲	䘲 量词“股”，一股气味叫“一䘲馟”
喃	喃 嘴里不停地念，像背诵佛经时的动作
威	威 ①欺吓人②威胁③美丽、威猛、帅气
寿	寿 呆，如“寿头寿脑”即“呆头呆脑”
抆	抆 用泥浆状物涂上去或把小洞小缝封住
整	整 ①修理②造，如“整屋”即建造房屋
滘	滘 两水相通的河流，浅的一边叫“滘”
紧	紧 ①表示动作在进行中②不宽，不宽裕
赁	赁 租赁，限于出钱租用家庭小用具或书
𬒔	𬒔 被隆起的或碎粒状的东西顶住或扎住
兜	兜 ①从下往上用手盛起舀起②量词“棵”
庵	庵 ①尼姑住的地方②被殴打之后隆起的包
捏	捏 ①用指甲捏住、掐②一点、很少的意思
探	探 探头探脑地慢步走，如“白鹤探沙洲”
搙	搙 ①戳，用尖物刺进去，同“督”②搓擦
枉	枉 ①枉费、徒然②蛋坏了，孵蛋不能成雏
皮	皮 ①计算单程路②计算墙壁③一半④足够
着	着 ①对、不错②穿③中了药毒叫“着药”
走	走 ①跑②“走都”，忌讳义，是死的意思
庹	庹 两臂向左右伸张的长度。可能是“庹”字
跳	跳 眼皮颤动，如“眼眉跳”即眼皮自己颤动
䟴	䟴 大小腿部上下弹动叫“䟴脚”或“䟴花蹄”
墟	墟 市集，如“等墟”即“赶集”，写作“圩”
扲	扲 伸手入洞中或袋中取东西，即“探囊取物”
生	生 ①“熟”的反义词②“死”的反义词③生疏
盛	盛 ①把往下坠或往下滴的东西装载起来②垫高
𢫘	𢫘 ①和、跟②拌、混合③胡混、谋生不择手段
利	利 ①快、尖、锋利②贪心、占便宜④利益、利润
栈	栈 放菜肴或碗筷的小橱柜，如“𩠌栈”“碗栈”
褛	褛 ①披②披风，大衣的通称③成群地围聚在一起
亏	亏 ①体弱，内虚②损失了、少了③冤枉、怀才不遇
捞	捞 ①把下垂的软东西往上抽②用手抬扛或用下臂扛
炼	炼 如“炼禾”即用牛拉石碾子把带谷的稻打出谷来
呷	呷 ①直接嘴吸饮液体的动作②菜或大叶子作物的叶柄
坳	坳 两峰相连，低下去的地方（不是低陷地方的意思）
屈	屈 ①培育豆芽的叫“屈豆芽”②被强迫拿出财物③烘
掠	掠 ①用勺子轻轻取去浮在水面的很细微的东西②薄取
横	横 ①冤屈、嫁祸②“横直”的“横”③木器中的横木
烂	烂 ①破，如碗打烂了②腐烂③食物煮得过久导致松软
囊	囊 ①水泡②用薄膜包东西，东西下垂凸出所形成的球形
扦	扦 杀牲畜时把刀刺进喉中的动作，用尖物刺进去的动作
掬	掬 增加肥料、饲料、食物等使植物、动物和人发育旺盛
胆	胆 ①胆、胆囊②胆量、勇气③给人做某事的胆量、勇气
惯	惯 习惯成白然，迁就，如“无好惯紧其”（不要迁就他）
能	能 ①杀，多用于杀三鸟禽类割喉放血的动作②健壮、有力
三	三 ①如“下三”即一种走子儿的游戏②如“三人”即讽刺人
堂	堂 ①十里路叫“一堂路”②计量液体单位，如“一堂臭水”
对	对 ①正确②量词“双”③对联④日夜循环一次是“一个对”
揼	揼 ①失据而倒②自上而下打下来③掉下④用手或棍棒打击物体
濑	濑 ①被火略烧伤②烫伤的灼痛感③四周有河流包围的小块土地
畅	畅 ①货币零整交换②用以保护“竹箩”或筐底下的几条大竹片
餐	餐 ①量词“顿”，如“一餐饭”、“打了一餐”（打了一顿）
呸	呸 ①因忌讳表示不满②骂人语，表示把不吉利的事情扇回给对方
盎	盎 ①用双手折断②垂直物的一部分朝外突出，形成不整齐的状态
缵	缵 ①捉鱼虾的竹器，鱼虾能入不能出，即“簖”。②聚合、聚敛
胶	胶 ①能黏合器物的物质②用蛋白等有胶质的东西浸网叫“胶网”
旺	旺 ①旺盛、兴旺②火力猛③称东西秤尾高些，即多称一点③用火烘
趯	趯 ①追逐，男性追求女性②赶走，驱逐③提、挑。自下而上的笔法
厌	厌 因常吃而不想吃叫厌，如“其吃猪肉吃厌都”（他吃猪肉吃腻了）
眤	眤 件、块、些。“昵”是土字。如“一脆水糕”“那昵事我都无知”
参	参 ①剧烈运动后，呼气紧迫叫“参气”。“气参参”指气喘吁吁②人参
特	特 ①把钉或楔打入他物②一端打入他物，另一端用来挂或系东西用的钉
蔂	蔂 织得比较疏的竹签。装柴草用叫“柴蔂”，套在牛口的叫“牛口蔂”
㔹	㔹 ①叻、聪明、机灵②响亮③内脏像受刺那样发痛④畦，“一㔹菜”即一畦菜
坎	坎 ①种菜的小穴叫“菜坎”，常作量词②自然形成或人工修筑的台阶状的东西
樸	樸 隆起的扁圆的物体、包，如“其个头壳起都个襥”（他的脑瓜碰起了个包）
沤	沤 ①未熟的果子藏起来让它成熟②煮东西停火让它慢慢熟③浸渍，用水浸使变质
笪	笪 ①竹片编织的像席子的竹器，常做船篷用②量词，计算一片粘在物体上的东西
上也	上也 好
上腭	上腭 腭
去货	去货 死
墨屎	墨屎 痣
山鸡	山鸡 雉
快脆	快脆 快
手凿	手凿 肘
涴错	涴错 脏
灰佬	灰佬 鬼
烧酒	烧酒 酒
稳磌	稳磌 稳
细妈	细妈 妾
细娘	细娘 妾
细婶	细婶 妾
缉畅	缉畅 斜
袍鱼	袍鱼 鳐
邋遢	邋遢 脏
鲩鱼	鲩鱼 鲭
大枱	大枱 坐8人的大方桌
㑷子	㑷子 那样
㓷颈	㓷颈 自刎
䞌底	䞌底 吃亏
一了	一了 向来
一胒	一胒 一些
三板	三板 舢板
上向	上向 赏脸
上堂	上堂 上课
上晏	上晏 上午
上水	上水 五脏
下低	下低 下面
下底	下底 下面
下晏	下晏 下午
下落	下落 着落
丑样	丑样 貌丑
丑生	丑生 丑角
丑鬼	丑鬼 难看
东边	东边 东面
为喉	为喉 贪吃
乃处	乃处 那里
乞儿	乞儿 乞丐
乞衣	乞衣 乞丐
乱讲	乱讲 胡说
了事	了事 既然
争交	争交 争辩
事熟	事熟 相熟
事话	事话 话语
二指	二指 食指
亚公	亚公 祖父
亚哥	亚哥 哥哥
亚奶	亚奶 母亲
亚婆	亚婆 祖母
亚嫂	亚嫂 嫂子
亚理	亚理 理亏
人客	人客 客人
今日	今日 今天
仔娘	仔娘 母子
仔爷	仔爷 父子
令仔	令仔 谜语
伙记	伙记 伙计
伢仔	伢仔 婴儿
佬仔	佬仔 男人
使黑	使黑 黄昏
依自	依自 既然
保头	保头 斧头
信筒	信筒 信封
倚侍	倚侍 倚仗
倾偈	倾偈 闲谈
做戏	做戏 演戏
做肉	做肉 糟糕
做队	做队 做伴
傲鼻	傲鼻 骄傲
傻仔	傻仔 傻子
儑鸡	儑鸡 病鸡
兔仔	兔仔 兔子
兜尿	兜尿 把尿
入去	入去 进去
入来	入来 进来
公响	公响 雷鸣
公打	公打 雷击
公鼻	公鼻 螵蛸
内伤	内伤 肺病
册花	册花 封包
冲身	冲身 淋浴
冻水	冻水 凉水
几多	几多 多少
出世	出世 出生
出声	出声 作声
出奇	出奇 奇怪
切肝	切肝 痛心
刨仔	刨仔 刨子
刨口	刨口 刨花
利息	利息 利润
前日	前日 前天
前时	前时 从前
千秋	千秋 秋千
卡世	卡世 阔气
即刻	即刻 立即
厅底	厅底 客厅
厌足	厌足 满足
去圩	去圩 赶集
去村	去村 探亲
发市	发市 交易
发梦	发梦 做梦
发身	发身 发育
叔侄	叔侄 同宗
古仔	古仔 故事
古粽	古粽 粽子
古肃	古肃 死板
号着	号着 凡是
吃酒	吃酒 喝酒
吊味	吊味 调味
吊颈	吊颈 自缢
后日	后日 后天
听闻	听闻 听见
吹鸡	吹鸡 吹哨
呕皿	呕皿 吐血
周时	周时 常常
咬身	咬身 合身
咸虾	咸虾 虾酱
哑吉	哑吉 口吃
唞气	唞气 呼吸
嚣离	嚣离 刻薄
四位	四位 四周
四处	四处 四周
围杆	围杆 桅樯
图诉	图诉 告诉
圆枱	圆枱 圆桌
土狗	土狗 蝼蛄
在意	在意 留神
在行	在行 内行
地豆	地豆 花生
地都	地都 死了
坐监	坐监 坐牢
塘蒿	塘蒿 茼蒿
塞督	塞督 愚蠢
墨砚	墨砚 砚台
墨笔	墨笔 毛笔
士的	士的 手杖
士胆	士胆 邮票
外低	外低 外面
外佬	外佬 岳父
外家	外家 娘家
外母	外母 岳母
夜学	夜学 夜校
夜宵	夜宵 宵夜
夜间	夜间 深夜
夜鹤	夜鹤 夜鹭
大一	大一 第一
大叔	大叔 堂倌
大姊	大姊 姐姐
大姑	大姑 姑母
大牙	大牙 臼齿
大蕉	大蕉 板蕉
大虫	大虫 老虎
大蠘	大蠘 喜鹊
大赏	大赏 大宗
大髀	大髀 大腿
天井	天井 院子
天光	天光 天亮
天星	天星 星星
天阴	天阴 阴天
太过	太过 过分
失引	失引 肮脏
失阳	失阳 阳痿
头先	头先 先前
头毛	头毛 头发
头蜡	头蜡 发蜡
头路	头路 早造
夹估	夹估 瞎猜
奀个	奀个 小个
好似	好似 好像
好天	好天 晴天
好痛	好痛 疼爱
如古	如古 如果
姑爷	姑爷 姑父
姨丈	姨丈 姨夫
姨婆	姨婆 姨母
威水	威水 好看
嫖舍	嫖舍 嫖娼
字帖	字帖 引格
字粒	字粒 铅字
学堂	学堂 学校
家下	家下 妻子
家俬	家俬 家具
家当	家当 财产
对岁	对岁 周岁
寿板	寿板 棺材
将就	将就 迁就
小妹	小妹 妹妹
小弟	小弟 弟弟
小格	小格 小气
小胆	小胆 胆小
小鬼	小鬼 小气
尾路	尾路 晚造
尿胀	尿胀 尿憋
尿龟	尿龟 夜壶
屋上	屋上 房顶
屋主	屋主 房东
屋己	屋己 家里
屋脊	屋脊 房脊
屋间	屋间 房间
屎忽	屎忽 屁股
屎桶	屎桶 马桶
屎胀	屎胀 尿憋
山窿	山窿 山洞
巡行	巡行 游行
布证	布证 布票
年时	年时 年令
年晚	年晚 年底
应承	应承 答允
底裤	底裤 内裤
廊仔	廊仔 耳房
异心	异心 偏爱
弼是	弼是 难怪
归天	归天 死了
当差	当差 当兵
得好	得好 以便
心事	心事 好意
心淡	心淡 灰心
怕丑	怕丑 害羞
思疑	思疑 怀疑
悖戾	悖戾 蛮横
悭先	悭先 刚才
悭悭	悭悭 刚才
懒佬	懒佬 懒汉
懵懂	懵懂 糊涂
成日	成日 整天
戒方	戒方 戒尺
房仔	房仔 女儿
所恃	所恃 倚仗
手袜	手袜 手套
手踭	手踭 手肘
扒摇	扒摇 船桨
打益	打益 打嗝
打脉	打脉 把脉
打跤	打跤 打架
托水	托水 借钱
执拾	执拾 收拾
执漏	执漏 补漏
执阄	执阄 抓阄
扫把	扫把 笤帚
抵死	抵死 该死
拕累	拕累 连累
拖桶	拖桶 抽屉
拘礼	拘礼 客气
拜候	拜候 拜访
拱子	拱子 这样
捉鲎	捉鲎 捉奸
捞篱	捞篱 笊篱
捰命	捰命 要命
掌心	掌心 手心
探米	探米 乞讨
插仔	插仔 秧苗
插手	插手 扒手
插田	插田 插秧
揤仔	揤仔 橡皮
揼骨	揼骨 按摩
搅档	搅档 捣乱
搅鬼	搅鬼 捣乱
搏命	搏命 拼命
搿钱	搿钱 凑钱
摩打	摩打 马达
擸𢶍	擸𢶍 垃圾
支光	支光 瓦特
收尾	收尾 末了
改处	改处 这里
散学	散学 放假
数簿	数簿 账本
整制	整制 虐待
斋菜	斋菜 素菜
斋身	斋身 戒色
断断	断断 断绝
新人	新人 新娘
旁屋	旁屋 厢房
无使	无使 不用
无委	无委 不会
日头	日头 太阳
日间	日间 白天
旧年	旧年 去年
旧时	旧时 从前
时年	时年 年成
时旧	时旧 仍旧
旺相	旺相 吉利
昨日	昨日 昨天
是但	是但 随便
晓得	晓得 懂得
晚黑	晚黑 晚上
晩黄	晩黄 黄昏
晾凉	晾凉 乘凉
暖水	暖水 温水
曱甴	曱甴 蟑螂
月大	月大 大月
月头	月头 月初
月小	月小 小月
月尾	月尾 月底
服侍	服侍 侍候
朝早	朝早 早晨
木虱	木虱 臭虫
本事	本事 本领
本心	本心 良心
村下	村下 乡村
来年	来年 明年
来日	来日 明天
来早	来早 明早
杧仔	杧仔 芒基
杧子	杧子 杧果
果个	果个 这个
果时	果时 这时
果阵	果阵 现左
架步	架步 阔气
架生	架生 工具
柜枱	柜枱 书桌
栏河	栏河 栏杆
树尾	树尾 树梢
树拐	树拐 树蛙
树桠	树桠 树枝
树胶	树胶 橡胶
桥凳	桥凳 长凳
梅肉	梅肉 里脊
榄子	榄子 橄榄
槌头	槌头 拳头
槌角	槌角 螺号
横人	横人 旁人
横𫠲	横𫠲 横竖
樽椊	樽椊 瓶塞
檐口	檐口 屋檐
正梁	正梁 栋梁
水喉	水喉 水管
水大	水大 潮涨
水干	水干 潮退
水脚	水脚 船费
水鞋	水鞋 雨鞋
水鸭	水鸭 野鸭
求其	求其 随便
污糟	污糟 污秽
沙尘	沙尘 鲁莽
沙马	沙马 沙蟹
沙鸡	沙鸡 蚁狮
油麻	油麻 芝麻
波恤	波恤 球衣
波鞋	波鞋 球鞋
泥嬲	泥嬲 泥鳅
洳水	洳水 漏水
清趣	清趣 好玩
渴市	渴市 卖断
游水	游水 游泳
湴窿	湴窿 泥潭
滑漏	滑漏 光滑
滚水	滚水 开水
漏就	漏就 仓促
火水	火水 煤油
火烛	火烛 火灾
火船	火船 轮船
火酒	火酒 酒精
灰鼠	灰鼠 蝙蝠
灶前	灶前 厨房
灶君	灶君 灶神
灶𡱽	灶𡱽 灶膛
炊笼	炊笼 蒸笼
烟仔	烟仔 香烟
烟火	烟火 烟花
热头	热头 太阳
煲茶	煲茶 煎药
熟咸	熟咸 丝盐
熟手	熟手 熟练
熟烟	熟烟 烟丝
爆当	爆当 说穿
片烟	片烟 鸦片
牙屎	牙屎 牙垢
牙罅	牙罅 牙缝
牙软	牙软 肉麻
牛乸	牛乸 母牛
牛公	牛公 公牛
牛牯	牛牯 公牛
牛精	牛精 蛮横
特登	特登 故意
犀利	犀利 厉害
犬鱼	犬鱼 梭鱼
犯仔	犯仔 犯人
独仔	独仔 独子
猪乸	猪乸 母猪
猪兜	猪兜 猪槽
猪栏	猪栏 猪圈
猪皿	猪皿 猪血
猪红	猪红 猪血
猪花	猪花 猪苗
猪郎	猪郎 种猪
瓜子	瓜子 水果
瓦口	瓦口 檐口
瓦钦	瓦钦 瓦片
甘罗	甘罗 伯劳
生咸	生咸 生盐
生牛	生牛 黄牛
生疔	生疔 长疗
生肉	生肉 胖了
生面	生面 陌生
甩身	甩身 脱身
田垌	田垌 田野
田基	田基 田埂
田螺	田螺 螺蛳
田鸡	田鸡 青蛙
甴曱	甴曱 蟑螂
电油	电油 汽油
电胆	电胆 电珠
电船	电船 汽船
番枧	番枧 肥皂
番薯	番薯 甘薯
疬核	疬核 瘰疬
症候	症候 病症
痕图	痕图 痕迹
白字	白字 别字
白日	白日 白天
白灰	白灰 石灰
白豆	白豆 黄豆
白鸠	白鸠 斑鸠
白鸽	白鸽 鸽子
盲佬	盲佬 瞎子
看小	看小 小看
看牛	看牛 放牛
眼浅	眼浅 忌妒
眼眉	眼眉 眉毛
着吊	着吊 狂乱
着数	着数 合算
睡梦	睡梦 做梦
瞓觉	瞓觉 睡觉
知实	知实 笃定
知得	知得 知道
矮仔	矮仔 矮人
石牯	石牯 石头
码子	码子 子弹
砧板	砧板 案板
碓坎	碓坎 石白
礼手	礼手 随手
离谱	离谱 走样
禾巷	禾巷 稻行
禾草	禾草 稻秆
禾镰	禾镰 镰刀
秉性	秉性 性格
秤砣	秤砣 秤锤
立乱	立乱 胡乱
立心	立心 存心
竹篙	竹篙 竹竿
笔筒	笔筒 笔帽
符弗	符弗 办法
筲筋	筲筋 抽筋
箭猪	箭猪 豪猪
米疖	米疖 疖疮
粗口	粗口 秽语
糠头	糠头 谷壳
紧板	紧板 一定
紧要	紧要 要紧
红银	红银 蛋黄
约莫	约莫 大约
纸媒	纸媒 草纸
纸鹞	纸鹞 风筝
终归	终归 终究
缠脚	缠脚 缠足
缺他	缺他 吉他
羊咩	羊咩 羊羔
翳心	翳心 伤心
翳腻	翳腻 娇媚
翻生	翻生 回生
老举	老举 妓女
老公	老公 丈夫
老子	老子 父亲
老襟	老襟 连襟
耳仔	耳仔 耳朵
耳屎	耳屎 耳垢
耳窿	耳窿 耳孔
肉蛇	肉蛇 蜥蜴
肉饼	肉饼 肉泥
肚卜	肚卜 腹部
肥佬	肥佬 胖子
背手	背手 贿赂
背晦	背晦 背部
背篷	背篷 背部
背驼	背驼 驼背
胶套	胶套 雨鞋
胶擦	胶擦 橡皮
胶鞋	胶鞋 球鞋
脚踭	脚踭 脚跟
脱色	脱色 褪色
脷仔	脷仔 小舌
膊头	膊头 肩膀
膝头	膝头 膝盖
膥脬	膥脬 阴囊
自在	自在 舒服
舅娘	舅娘 舅母
舅爷	舅爷 内弟
色子	色子 骰子
花家	花家 浪费
花飞	花飞 花费
茶枱	茶枱 茶桌
茶瓶	茶瓶 茶壶
草狗	草狗 蝼蛄
莲米	莲米 莲子
莲花	莲花 荷花
菜干	菜干 干菜
菜果	菜果 苤蓝
落仔	落仔 流产
落去	落去 下去
落堂	落堂 下课
落水	落水 下雨
落泊	落泊 落魄
蓑衫	蓑衫 蓑衣
蕉子	蕉子 香蕉
蕹菜	蕹菜 通菜
薄刀	薄刀 菜刀
薄鱼	薄鱼 鲢鱼
虱乸	虱乸 虱子
虾仁	虾仁 虾米
虾糠	虾糠 虾皮
虾膥	虾膥 虾卵
蚊子	蚊子 苍蝇
蚊虫	蚊虫 蚊子
蛤蒟	蛤蒟 蒟蒻
蛮皮	蛮皮 顽皮
蟹公	蟹公 公蟹
蠄蟧	蠄蟧 蜘蛛
行情	行情 行市
街巷	街巷 街道
表仔	表仔 手表
衫袖	衫袖 袖子
衫里	衫里 里子
衫领	衫领 领子
衲婆	衲婆 棉袄
袋表	袋表 怀表
袜头	袜头 短袜
被单	被单 被套
被袋	被袋 被套
裹粽	裹粽 粽子
裹蒸	裹蒸 粽子
褂仔	褂仔 背心
褛仔	褛仔 小楼
誓愿	誓愿 发誓
讲嘴	讲嘴 谈话
设若	设若 假如
话知	话知 告诉
谷壳	谷壳 稻壳
豆角	豆角 豇豆
走身	走身 遗精
起势	起势 开始
起号	起号 暗示
起头	起头 开始
足蟀	足蟀 蟋蟀
路水	路水 洪水
路用	路用 旅费
路线	路线 门路
路货	路货 洋货
路鸦	路鸦 乌鸦
躀虫	躀虫 孑孓
躲懒	躲懒 偷懒
车货	车货 暗娼
车辘	车辘 车轮
边处	边处 哪里
过家	过家 串门
过际	过际 过瘾
透风	透风 刮风
逗火	逗火 生火
遮瞒	遮瞒 掩饰
那霍	那霍 地名
郎家	郎家 女婿
郞家	郞家 女婿
酒凹	酒凹 酒窝
酥粉	酥粉 粉丝
里头	里头 里面
金猪	金猪 烧猪
针顶	针顶 顶针
钱甖	钱甖 扑满
铜绿	铜绿 铜锈
铰剪	铰剪 剪刀
铲山	铲山 扫墓
银包	银包 钱包
银纸	银纸 钞票
锁匙	锁匙 钥匙
锑罂	锑罂 铝锅
锯牙	锯牙 锯齿
镬㞘	镬㞘 锅底
镬涮	镬涮 炊帚
镬𡰪	镬𡰪 锅底
门槛	门槛 门槛
闪令	闪令 闪电
闲长	闲长 往常
间中	间中 偶或
闸刀	闸刀 铡刀
阴虚	阴虚 阴险
阿叔	阿叔 叔叔
阿哥	阿哥 哥哥
阿大	阿大 大姐
阿妗	阿妗 舅母
阿姆	阿姆 伯母
阿姐	阿姐 姐姐
阿姑	阿姑 姑母
阿姨	阿姨 姨母
阿爷	阿爷 家翁
难为	难为 为难
雀枪	雀枪 鸟枪
雨褛	雨褛 雨衣
雪条	雪条 冰棍
雷公	雷公 雷神
露风	露风 漏风
面墩	面墩 面颊
面条	面条 挂面
面盆	面盆 脸盆
鞋膏	鞋膏 鞋油
鞋踭	鞋踭 鞋跟
顾式	顾式 小心
颈巾	颈巾 围巾
颈柄	颈柄 脖子
颈链	颈链 项链
风水	风水 堪舆
飒口	飒口 零食
飒星	飒星 零星
飞鼠	飞鼠 蝙蝠
香枧	香枧 香皂
香芹	香芹 芹菜
马乸	马乸 母马
马公	马公 公马
马寡	马寡 调皮
马汗	马汗 狐臭
马骝	马骝 猴子
驳命	驳命 拼命
驳艇	驳艇 驳船
骨牌	骨牌 牌九
髻巾	髻巾 头绳
髻簪	髻簪 簪子
鱼摆	鱼摆 鱼鳍
鱼泡	鱼泡 鱼鳔
鱼竻	鱼竻 鱼刺
鱼肋	鱼肋 鱼刺
鱼花	鱼花 鱼苗
鲗鱼	鲗鱼 鲫鱼
鸡乸	鸡乸 母鸡
鸡公	鸡公 公鸡
鸡肶	鸡肶 鸡腿
鸡膥	鸡膥 鸡蛋
鸡谷	鸡谷 红鱼
鸡颈	鸡颈 米证
鹅膥	鹅膥 鹅蛋
麻仔	麻仔 麻疹
麻糖	麻糖 糖果
黄糖	黄糖 红糖
黄蜂	黄蜂 马蜂
鼻䆔	鼻䆔 鼻孔
鼻水	鼻水 鼻涕
齐家	齐家 大家
龟婆	龟婆 鸨母
𡌶窿	𡌶窿 泥潭
𡱮钉	𡱮钉 图钉
𢫘须	𢫘须 捣乱
𢲲仔	𢲲仔 蒸架
𣬬毛	𣬬毛 睫毛
𫣶赖	𫣶赖 依赖
㓟丁	㓟丁 占便宜
一缗	一缗 一元钱
不子	不子 表疑问
做中	做中 中介者
净系	净系 简直是
几松	几松 不要紧
出恭	出恭 解大便
势着	势着 不得已
勾头	勾头 头垂下
包尾	包尾 包余儿
单车	单车 自行车
吃饮	吃饮 喝米汤
吽佬	吽佬 笨男人
呷浪	呷浪 打哈欠
园威	园威 稻草人
在心	在心 不忘记
地蒲	地蒲 葫芦瓜
坐月	坐月 坐月子
塘仔	塘仔 小池塘
外公	外公 外祖父
外婆	外婆 外祖母
大婆	大婆 大老婆
太公	太公 曾祖父
太婆	太婆 曾祖母
夹万	夹万 保险箱
契仔	契仔 干儿子
契女	契女 干女儿
姑婆	姑婆 姑奶奶
婆仔	婆仔 老婆婆
寡佬	寡佬 单身汉
屙肚	屙肚 拉肚子
岔腮	岔腮 腮腺炎
巷仔	巷仔 小胡同
巷口	巷口 胡同口
得滞	得滞 太、极
戆仔	戆仔 傻孩子
戆婆	戆婆 傻妇人
打仔	打仔 小无赖
打风	打风 刮大风
捱刑	捱刑 活受罪
掤鸡	掤鸡 扣扳机
搅笑	搅笑 开玩笑
搅趣	搅趣 开玩笑
撞板	撞板 碰钉子
斗木	斗木 做木工
断尾	断尾 无后代
新府	新府 儿媳妇
无谓	无谓 不应该
旧水	旧水 不新鲜
木瓜	木瓜 木冬瓜
未爽	未爽 不同意
桠杈	桠杈 木叉子
椰菜	椰菜 洋白菜
槌仔	槌仔 小槌子
欧冤	欧冤 闹情绪
水车	水车 龙骨车
沙钻	沙钻 沙锥鱼
洋遮	洋遮 布雨伞
涂仔	涂仔 弹涂鱼
溦溦	溦溦 毛毛雨
牛气	牛气 不讲理
琴蛇	琴蛇 大蟒蛇
生手	生手 不熟练
生油	生油 花生油
生野	生野 不驯服
田威	田威 稻草人
电发	电发 烫头发
电芯	电芯 干电池
番茄	番茄 西红柿
盲仔	盲仔 瞎小孩
盲婆	盲婆 瞎妇人
直系	直系 简直是
眼核	眼核 眼珠儿
眼眶	眼眶 眼圈儿
眼瞓	眼瞓 打盹儿
碗缿	碗缿 破碗片
笔嘴	笔嘴 钢笔尖
等试	等试 待会儿
米碎	米碎 碎米粒
粉酥	粉酥 炒米饼
粟米	粟米 高粱米
纳仔	纳仔 小发夹
纸扑	纸扑 马粪纸
细仔	细仔 小孩儿
绒裤	绒裤 呢子裤
绝嗣	绝嗣 无后代
耳牌	耳牌 耳坠子
耳镜	耳镜 耳鼓膜
肚刺	肚刺 肚子痛
肥婆	肥婆 胖妇女
脚甲	脚甲 脚趾甲
脚迹	脚迹 脚印儿
药单	药单 药方子
菜呷	菜呷 菜叶柄
菜骨	菜骨 菜帮子
落雹	落雹 下雹子
蒲瓜	蒲瓜 葫芦瓜
蚝豉	蚝豉 干牡蛎
蝠鼠	蝠鼠 大蝙蝠
蟹贡	蟹贡 蟹的鳖
蠄蜍	蠄蜍 癞蛤蟆
街仔	街仔 小街道
衲仔	衲仔 小棉袄
记性	记性 记忆力
试跟	试跟 一会儿
试辰	试辰 一会儿
豆米	豆米 花生仁
较尚	较尚 打石仗
辣蛆	辣蛆 象鼻虫
那阵	那阵 那时候
酒楼	酒楼 大饭店
野仔	野仔 私生子
野妹	野妹 私生女
金鈪	金鈪 金手镯
钱鳞	钱鳞 穿山甲
镊仔	镊仔 拔毛器
镰仔	镰仔 割草刀
间仔	间仔 小屋子
阻滞	阻滞 不顺利
阿太	阿太 曾祖母
雪糕	雪糕 冰激凌
青翠	青翠 翡翠鸟
鞋抽	鞋抽 鞋拔子
鞋楦	鞋楦 鞋楦子
须刨	须刨 刮胡刀
颈褛	颈褛 围脖儿
饭壳	饭壳 饭勺子
马布	马布 月经带
驳壳	驳壳 盒子枪
驶口	驶口 供使唤
高佬	高佬 高汉子
鬼鼠	鬼鼠 不诚实
魂精	魂精 太阳穴
鸭项	鸭项 小母鸭
麻油	麻油 芝麻油
鼻浓	鼻浓 浓鼻涕
𡱮鱼	𡱮鱼 黄花鱼
𪜃子	𪜃子 怎么样
𰪪素	𰪪素 糕饼馅
上作	上作 上流之意
下气	下气 忍气吞声
两家	两家 彼此双方
京炭	京炭 上等木炭
今晏	今晏 今天午间
今朝	今朝 今天早上
假精	假精 自作聪明
做种	做种 留种繁殖
其也	其也 催促语气
几大	几大 无论如何
华离	华离 贪得无厌
呕水	呕水 令人作呕
呕油	呕油 令人作呕
周流	周流 时时刻刻
嚡惶	嚡惶 心情焦急
围夹	围夹 扁桃腺炎
塘鸭	塘鸭 普通家鸭
外太	外太 外曾祖母
外水	外水 海外财流
大个	大个 体型高大
好丑	好丑 人情道理
家斗	家斗 家庭人口
寡情	寡情 人情淡薄
对嘴	对嘴 核对口供
尯佬	尯佬 跛脚男人
屎蛆	屎蛆 苍蝇幼虫
岧荛	岧荛 高而不稳
布癞	布癞 碎布条子
帮衬	帮衬 与之交易
幅辘	幅辘 附近一带
废柴	废柴 无用之物
开耕	开耕 耕作开始
心狼	心狼 心狠、凶
扭偈	扭偈 耍小性子
捱牛	捱牛 做牛做马
揼迳	揼迳 半路抢劫
擤鼻	擤鼻 ①擤鼻涕
攙车	攙车 随嫁婢女
收水	收水 商店倒闭
放晚	放晚 晚上放学
放朝	放朝 上午放学
斗霸	斗霸 批斗恶霸
无好	无好 不要、别
早排	早排 前些时候
晚黄	晚黄 黄昏时候
来晏	来晏 明天中午
来晚	来晚 明天晚上
来朝	来朝 明天早上
果掉	果掉 从此以后
水笔	水笔 自来水笔
水路	水路 水上通道
沙记	沙记 鲁莽的人
波板	波板 乒乓球拍
波珠	波珠 玻璃弹珠
泥湴	泥湴 泥土浆水
洋号	洋号 号、喇叭
火筒	火筒 吹火工具
炙火	炙火 烤火取暖
生嘢	生嘢 有疮疥病
白饭	白饭 没菜的饭
磁漆	磁漆 漆的一种
禁谂	禁谂 善于思考
秃骨	秃骨 骨位收缩
第尾	第尾 最后一名
粉皮	粉皮 一种河粉
系得	系得 只、仅仅
翳喉	翳喉 同“翳”
老同	老同 同名的人
老娘	老娘 女人傲称
老格	老格 少年老成
肉猪	肉猪 肉用的猪
肥仔	肥仔 胖小孩儿
脚䏙	脚䏙 小腿肚子
船脚	船脚 乘船费用
落笠	落笠 中了圈套
葭子	葭子 露兜树果
蔗呷	蔗呷 甘蔗叶子
蔗扑	蔗扑 甘蔗残渣
虾公	虾公 淡水大虾
蛋堆	蛋堆 老态龙钟
行雷	行雷 闪电雷鸣
衫脚	衫脚 上衣下摆
装整	装整 打扮整容
裤脚	裤脚 裤腿下沿
贼头	贼头 盗贼首领
走假	走假 以假当真
走贼	走贼 躲避盗贼
起市	起市 货物畅销
边途	边途 什么地方
过背	过背 老人去世
迟禾	迟禾 晚造水稻
高斗	高斗 自高自大
鸡贩	鸡贩 贩鸡的人
麻茶	麻茶 看不清楚
麻蒙	麻蒙 朦朦胧胧
黑心	黑心 心狠恶毒
𠮳𠮴	𠮳𠮴 花狭口蛙
㧻仔	㧻仔 扒手、小偷
䲞鱼	䲞鱼 鱲鱼，鲷科
中意	中意 喜欢、爱好
乜子	乜子 也许、可能
事干	事干 事儿、事情
亚嫲	亚嫲 丈夫的妈妈
交带	交带 叮咛、吩咐
今谢	今谢 谢谢、多亏
偈油	偈油 机器润滑油
做下	做下 全都、全部
傻佬	傻佬 疯子、傻瓜
冇见	冇见 遗失、丢掉
几侨	几侨 时髦、洋气
出街	出街 上市、上街
利事	利事 红包、封包
利家	利家 指吝啬的人
剃刀	剃刀 理发用的刀
功夫	功夫 本领、造诣
勤力	勤力 勤谨、努力
包子	包子 有馅的面包
发面	发面 翻脸、生气
口角	口角 争吵的话语
后尾	后尾 后面，背后
吓吓	吓吓 不满的语气
吵耳	吵耳 吵闹、嘈杂
呷醋	呷醋 吃醋、妒忌
响名	响名 出名、有名
喊做	喊做 叫作、称为
四幅	四幅 附近、周围
困怅	困怅 混账、无耻
地拖	地拖 拖帚、拖把
地鼠	地鼠 老鼠的一种
声口	声口 音信、消息
声喉	声喉 嗓子、唱腔
声气	声气 音信、消息
处所	处所 地方、场所
大碌	大碌 很粗的一条
大褛	大褛 大氅、大衣
大齐	大齐 大家、大众
天闪	天闪 打闪，闪电
头壳	头壳 脑袋、头部
夹硬	夹硬 硬要，强行
好声	好声 小心、轻轻
好得	好得 多亏、好在
好样	好样 美观、漂亮
妾侍	妾侍 小老婆、妾
姊夫	姊夫 姊丈、姐夫
姑娘	姑娘 丈夫的姐姐
媒公	媒公 做媒的男人
孤寒	孤寒 吝啬、寒酸
尾仔	尾仔 最小的儿子
尾冬	尾冬 冬天的后期
尾春	尾春 春天的后期
屋𡰪	屋𡰪 屋的角落里
巷尾	巷尾 胡同的末端
巽门	巽门 脑门、项门
帮手	帮手 帮忙、帮助
底衫	底衫 衬衣、内衣
归服	归服 屈服、服从
彩数	彩数 幸运、运气
得闲	得闲 空闲、有空
心乐	心乐 乐意、情愿
心口	心口 胸膛、心窝
心机	心机 耐心、细心
收箕	收箕 竹编品名称
无该	无该 ①谢谢②请
时步	时步 时候、时势
晒油	晒油 酱油的一种
月中	月中 月半、月中
果排	果排 最近、近来
椅拼	椅拼 椅子的靠背
椅搭	椅搭 遮椅子的布
槽行	槽行 宰猪的行业
樏仔	樏仔 密齿小梳子
气响	气响 断气、死了
水壳	水壳 舀水的勺儿
波泵	波泵 球的打气筒
泥霉	泥霉 土中腐殖质
洋楼	洋楼 洋房、大楼
海碗	海碗 最大的汤碗
淹尖	淹尖 烦闷、烦躁
滚搞	滚搞 打扰、搅扰
漏夜	漏夜 彻夜、深夜
潺虫	潺虫 蛞蝓，蜒蚰
火头	火头 厨子炊事员
灵动	灵动 机灵、灵活
炒粉	炒粉 炒制的粉皮
炮仗	炮仗 爆竹、鞭炮
烟尘	烟尘 灰尘、尘土
焗发	焗发 用电烫头发
爱呕	爱呕 恶心、想吐
牛佬	牛佬 不讲理的人
牛栏	牛栏 牛屋、牛棚
牛簏	牛簏 牛屋、牛棚
狼狂	狼狂 慌忙、急忙
瓜核	瓜核 瓜类的种子
瓜米	瓜米 瓜类的种子
生膥	生膥 产卵、下蛋
生鸡	生鸡 未阉的公鸡
番摊	番摊 赌博的一种
番芋	番芋 芋头的一种
白鼻	白鼻 好淫、轻佻
皮喼	皮喼 手提皮箱子
皮篢	皮篢 大的皮箱子
相啱	相啱 要好、相好
相思	相思 暗绿绣眼鸟
眉头	眉头 两眉的前头
着霍	着霍 染上霍乱病
矮瓜	矮瓜 茄子的别名
笠衫	笠衫 线衣、内衣
箩斗	箩斗 筛粉的用具
粒仔	粒仔 小疮的通称
纸撚	纸撚 纸搓的绳子
线鸡	线鸡 阉过的公鸡
经济	经济 便宜、合算
缆豆	缆豆 花生的一种
老番	老番 白人外国人
肚屙	肚屙 腹泻、拉稀
背尾	背尾 后面，背后
背底	背底 后面，背后
背脊	背脊 脊背、背部
胶辘	胶辘 车胎、外胎
能械	能械 健康、壮实
脆口	脆口 食品很酥脆
脚钵	脚钵 洗脚的盆儿
芋呷	芋呷 芋头的叶柄
芫茜	芫茜 香菜、芫荽
英笔	英笔 水笔，钢笔
菲林	菲林 软片、胶卷
落雷	落雷 打雷下大雨
葭虎	葭虎 豹虎方胸蛛
蚝仔	蚝仔 一种小牡蛎
行船	行船 在船上工作
街招	街招 广告、启示
襟章	襟章 徽章、胸章
要紧	要紧 重要、紧迫
记紧	记紧 惦记、牢记
论夜	论夜 成夜、整夜
论尽	论尽 不妥、局促
试尿	试尿 抱婴儿把尿
败水	败水 去势、败势
走鸡	走鸡 错过好机会
起福	起福 在神前起愿
起身	起身 起来、起床
趁势	趁势 顺便、趁机
跟手	跟手 立刻、马上
身热	身热 发烧、发热
身粗	身粗 有孕、怀胎
邓家	邓家 疍家、疍民
鄙耻	鄙耻 侮辱、耻笑
酸菜	酸菜 泡菜，味酸
金勾	金勾 虾仁的别名
钓仔	钓仔 小鱼钩、钓
铁线	铁线 铅丝、铁丝
闲时	闲时 从前、往常
阴功	阴功 毒辣、害人
阴司	阴司 阴间、地狱
阴毒	阴毒 毒辣、阴险
阿孻	阿孻 最小的儿女
阿尾	阿尾 最小的儿女
阿𡥧	阿𡥧 最小的儿女
雀乸	雀乸 雌鸟的通称
雀仔	雀仔 小鸟或雏鸟
雀公	雀公 雄鸟的通称
零琼	零琼 越发、更加
雾水	雾水 露，露水珠
面前	面前 前边、前面
面风	面风 脸色、嘴脸
顺笔	顺笔 顺手、顺便
饭焦	饭焦 米饭的锅巴
鱼约	鱼约 公鱼的精子
龙脷	龙脷 鲽形目鱼类
龟公	龟公 偷情的男人
𠯋嘢	𠯋嘢 不好的东西
𠹌子	𠹌子 那样、那么
晏昼	晏昼 中午。正午12点钟又叫“晏昼正”
三鸟	三鸟 鸡、鸭、鹅3种家禽的总称
㓟书	㓟书 埋头看书学习
㓟家	㓟家 努力读书的人
上下	上下 差点儿、将要
上田	上田 农事收割完毕
世艺	世艺 可以消磨时间
人士	人士 指人品、人脉
人工	人工 ①工薪②人力
伶俐	伶俐 ①干净②聪明
信肉	信肉 写了字的信笺
做得	做得 ①能干②可以
冰盘	冰盘 大而浅的盘子
凉粉	凉粉 用凉粉草煮制
几久	几久 多久、多会儿
卒之	卒之 到底、到头来
发尸	发尸 尸体多年不化
叔爷	叔爷 夫弟，小叔子
吊市	吊市 抬高价钱出售
喂狗	喂狗 女人骂男人语
地塘	地塘 打谷场、晒场
墟巷	墟巷 墟镇里的巷道
外甥	外甥 ①外孙②外甥
大戏	大戏 粵剧或古装戏
大肉	大肉 泛指全身肌肉
天收	天收 死（骂人语）
孖仔	孖仔 双胞胎男孩子
孖女	孖女 双胞胎女孩子
学口	学口 模仿别人的话
家用	家用 家庭日常开支
小工	小工 泥瓦匠的助手
开身	开身 船启碇，开行
得计	得计 以为计谋得逞
戆佬	戆佬 傻子（成年）
扒挖	扒挖 ①忙碌②奔波
捞手	捞手 ①残手②拙劣
撚化	撚化 戏弄，玩残了
无系	无系 ①否则②不是
晏觉	晏觉 午睡、睡午觉
晩黑	晩黑 ①天黑②夜晚
机船	机船 有发动机的船
来世	来世 来生、下辈子
来蛇	来蛇 事情又发生了
架死	架死 硬拼、不怕死
棉褛	棉褛 棉大衣、棉袄
水利	水利 水渠、水库等
水衣	水衣 防水衣、雨衣
洋鼓	洋鼓 游行用的铜鼓
清油	清油 花生油、豆油
清私	清私 清静，无干扰
溦丝	溦丝 瘦弱、不粗壮
烫斗	烫斗 熨衣服的器具
牛牸	牛牸 未生子的母牛
猪唛	猪唛 像猪一样难看
瓜仁	瓜仁 剥了皮的瓜核
瓜咸	瓜咸 越瓜腌的咸菜
电火	电火 ①电灯②手电
癞痂	癞痂 癞病结的疙瘩
白银	白银 ①银子②蛋白
皮蛋	皮蛋 松花蛋、变蛋
着紧	着紧 着急、很注意
矮敦	矮敦 又肥又矮的人
石仔	石仔 石子、小石头
硬颈	硬颈 倔强、不认输
礼事	礼事 礼物、礼金等
禾事	禾事 水稻生长情况
稔子	稔子 桃金娘科植物
窦含	窦含 排水沟的洞口
箸笼	箸笼 装筷子的器具
索窖	索窖 成双的小渔船
紧手	紧手 不宽裕、困难
累坠	累坠 不舒服、别扭
老大	老大 排难解纷的人
耳盅	耳盅 漱口盅、茶缸
背语	背语 俏皮话、隐语
艇仔	艇仔 无桅的小渡船
色笔	色笔 画图用的色笔
落泵	落泵 事情办得周妥
落着	落着 有着落，如意
蛤邑	蛤邑 珞肢窝，腋下
蛮犁	蛮犁 蛮横、不讲理
衰仔	衰仔 女人骂孩子语
裤头	裤头 短裤子、裤衩
贱格	贱格 下流、不自爱
贼佬	贼佬 大盗（男的）
贼公	贼公 大盗（男的）
贼婆	贼婆 大盗（女的）
赖夜	赖夜 夜晚带狗围猎
赤眼	赤眼 急性眼结膜炎
踎墩	踎墩 赋闲、无事做
软熟	软熟 软绵绵、柔软
野鸡	野鸡 旧社会时妓女
金瓜	金瓜 南瓜、老倭瓜
金针	金针 黄花菜、针菜
钱串	钱串 串铜钱的绳子
钵头	钵头 浅小的“钵”
铺尾	铺尾 商店后座房屋
门楣	门楣 门框上的横木
阿伯	阿伯 ①伯伯②伯父
阿公	阿公 ①爷爷②祖父
阿妈	阿妈 ①妈妈②母亲
阿婆	阿婆 ①奶奶②祖母
阿婶	阿婶 ①婶婶②婶母
阿嫲	阿嫲 ①奶奶②祖母
阿爸	阿爸 ①爸爸②父亲
阿舅	阿舅 ①舅舅②舅父
雨水	雨水 统称所下的雨
靓仔	靓仔 帅哥、美男子
颈渴	颈渴 口渴，想喝水
飒碎	飒碎 ①零碎②零用
饮酒	饮酒 ①喝酒②赴宴
驶咪	驶咪 何必、用不着
鼻屎	鼻屎 鼻子中的脏物
𫣶福	𫣶福 凭关系占便宜
𬒔肚	𬒔肚 挨饿，没吃的
丝发	丝发 丝料子、丝织品
中褛	中褛 不长不短的大衣
亲家	亲家 姻家（指男人）
作色	作色 显摆、自高自大
侄仔	侄仔 侄，兄弟的儿子
侉妹	侉妹 说外地话的姑娘
侉婆	侉婆 说外地话的妇人
偷卷	偷卷 夹带，考试犯规
入门	入门 招赘婿或做赘婿
几何	几何 难得，好不容易
几时	几时 什么时候，何时
到钟	到钟 到时候、到时间
势凶	势凶 气势汹汹，凶恶
南乳	南乳 红豆腐或酱豆腐
口盅	口盅 漱口盅、茶缸子
叹记	叹记 享受，逍遥自在
吊瘾	吊瘾 引起兴头而终止
吟噆	吟噆 为人性格不开朗
咸湿	咸湿 ①色迷迷②褴褛
地主	地主 ①土地神②地主
坏鬼	坏鬼 指心术不正之人
大血	大血 怕被人家占便宜
大面	大面 脸皮厚、不害臊
天公	天公 天神，又指雷神
头口	头口 纺纱接线的线头
好事	好事 ①幸运②事情好
好手	好手 右手（婉说法）
寡酒	寡酒 没有菜肴时喝酒
对时	对时 次日的同一时间
应嘴	应嘴 回辩、反言相骂
心兽	心兽 贪得无厌、凶狠
心定	心定 有把握、不犹豫
扤扣	扤扣 按扣、弹簧掀扣
担带	担带 担当，负起责任
拗颈	拗颈 顶嘴，故意争辩
摆计	摆计 设圈套、想办法
撩天	撩天 调皮，惹人讨厌
斋口	斋口 不随便吃，戒口
斗趣	斗趣 闹着玩、不当真
新鲜	新鲜 ①鲜鱼②不陈旧
机器	机器 ①留声机②机械
板蕉	板蕉 较高的一种芭蕉
架之	架之 孤注一掷的意思
根种	根种 种子，遗传特质
椅披	椅披 椅子靠背的套子
楼下	楼下 第一层楼、一楼
楼地	楼地 第一层楼、一楼
水船	水船 给船上供水的船
沉实	沉实 沉着老实、稳重
波饼	波饼 被球撞击了一下
泥仔	泥仔 建筑工中的小工
泥心	泥心 狠心，胆大包天
淡情	淡情 没有一点人情味
火喉	火喉 罩油灯的玻璃管
烂口	烂口 秽亵的话、粗口
猪中	猪中 生猪交易的中介
生精	生精 虚假、无中生有
田寮	田寮 阳江的一个地名
盐漏	盐漏 晒制食盐的场所
着衫	着衫 穿衣服或穿上衣
禾束	禾束 扎成束的稻秆草
秃头	秃头 头屈缩，伸不直
竹蔗	竹蔗 较小的一种甘蔗
篾仔	篾仔 竹子削成的薄片
米鼻	米鼻 大米胚或碎米粒
紧较	紧较 卡住了，不松动
织箦	织箦 镇名，在阳西县
聋佬	聋佬 聋子（成年的）
臭丸	臭丸 樟脑丸、卫生丸
蚝督	蚝督 一种打蚝的工具
行街	行街 在街上走，逛街
行运	行运 走红运、好运气
识得	识得 认识，同“识”
诡谲	诡谲 善于取巧、机灵
谷爆	谷爆 用稻谷爆的米花
豆肚	豆肚 扪身的布，围兜
费事	费事 嫌麻烦，懒得干
跟班	跟班 侍从、随从人员
过门	过门 女性嫁到男方家
还嘴	还嘴 回辩或反言相骂
逻田	逻田 到田里看看情况
铁闸	铁闸 防盗贼的铁门栅
面架	面架 放洗脸盆的架子
韶菜	韶菜 黄芽白、大白菜
驶得	驶得 行、能干、可用
驶气	驶气 往别人身上出气
鬼屎	鬼屎 不公道、不公正
鸡窦	鸡窦 供鸡下蛋用的窝
鸡项	鸡项 未下蛋的小母鸡
䟴脚	䟴脚 大小腿部上下弹动
上门	上门 女婿初次到岳父家
丸仔	丸仔 药丸、药片的总称
井头	井头 水井和附近的地面
冲凉	冲凉 洗澡，冷水浴为常
几韭	几韭 好彩、凑巧、巧遇
反转	反转 ①反而②翻转过来
另自	另自 分外、单独、格外
同志	同志 对“干部”的称谓
后生	后生 ①年轻②年轻的人
咬脚	咬脚 合脚，指鞋子合穿
回尾	回尾 接受东西退回少许
回示	回示 接受礼物回敬一些
圆钉	圆钉 口径成圆形的钉子
坏骨	坏骨 不守规矩、无道德
墨斗	墨斗 弹墨线的木工工具
大日	大日 将来或过一段时间
天水	天水 下雨时盛起来的水
奇理	奇理 整齐、干净、雅观
孖带	孖带 用于背孩子的背带
定份	定份 规规矩矩，不爱闹
寡瘦	寡瘦 形容食物没有油水
屎坑	屎坑 茅坑、储粪便的坑
屎布	屎布 为婴孩特设的尿布
底㞘	底㞘 底层、内层、底下
底𡰪	底𡰪 底层、内层、底下
弟婶	弟婶 弟弟的妻子，弟妹
戒口	戒口 因病忌食某种东西
扤定	扤定 必定、必然、一定
扯索	扯索 为嫖客或妓女牵线
拖挞	拖挞 做事拖拉拖泥带水
捰吃	捰吃 找事做以维持生活
搅场	搅场 骚扰、干扰、捣乱
方钉	方钉 口径成方形的钉子
村佬	村佬 乡下人（有贬义）
果胒	果胒 这些、这件、这块
桓仔	桓仔 女儿，同“房仔”
毛仔	毛仔 寒毛、脸毛、汗毛
沤仔	沤仔 怀孕时的生理状态
洳逳	洳逳 动作、动静、反应
漏寿	漏寿 不光彩、样子寒酸
烂货	烂货 行为不正当的女人
生虫	生虫 东西有虫，给蛀了
疳积	疳积 小儿肠胃病的一种
着愀	着愀 突然头晕失去知觉
石碌	石碌 碌碡，碾子的一种
碎纸	碎纸 ①零钞②零碎的纸
磡头	磡头 山崖，险陡的堤岸
积了	积了 一向、向来、历来
稳阵	稳阵 牢靠、坚实、稳妥
米证	米证 专买大米用的粮票
粪厕	粪厕 厕所，同“粪簏”
缸瓦	缸瓦 瓦器、陶器的总称
翅仔	翅仔 地鱼干，煮汤上品
胶带	胶带 用塑料做成的长条
腊味	腊味 腊鸭、腊肉等总称
腻凤	腻凤 忸怩，做事动作慢
臭佬	臭佬 即女人与男人私通
芋子	芋子 芋头旁边的小芋头
蒜藕	蒜藕 大蒜头拆开的瓣儿
行藏	行藏 走路的姿势、体态
衫裤	衫裤 上衣和裤子，衣服
衰公	衰公 潦倒、倒莓的男人
衰鬼	衰鬼 潦倒、不阔绰的人
趠袊	趠袊 比喻女子作风不正
蹾臀	蹾臀 屁股蹾，着地很重
邑曳	邑曳 为人小气，不大方
酥炸	酥炸 油炸，使食品松脆
重载	重载 船装载的东西很重
锄䦁	锄䦁 薄而宽的一种镢头
雪水	雪水 南方冬天下的冷雨
鼠志	鼠志 很小气、胸无大志
𢯎仔	𢯎仔 锄地松土的铁耙子
𪥕恤	𪥕恤 因不满而言语粗野
𬕍仔	𬕍仔 圆形有眼的竹编盛
书房	书房 学校或储书供学之房
交关	交关 ①利害②小气③严重
充阔	充阔 装腔作势，冒充阔佬
大嘥	大嘥 大手大脚，浪费财物
大支	大支 对财物不吝啬，大方
大苟	大苟 对待财物表面很随便
天好	天好 天晴，有太阳的天气
天棚	天棚 屋项晒晾衣物的地方
好佬	好佬 怪诞、不正经、调皮
好彩	好彩 ①幸运②好在、幸亏
子细	子细 ①忌讳②拍礼，礼让
密梳	密梳 篦，很密的一种梳子
岦岌	岦岌 崎岖不平，坑坑洼洼
崖鹘	崖鹘 鹰的一种，个头小的
恶佬	恶佬 恶人，恃势欺人的人
懵送	懵送 迷糊，刚睡醒的状态
扤钉	扤钉 图钉。也叫“画钉”
抵力	抵力 痛苦、不好受、难堪
揾笨	揾笨 占便宜、吃亏、受骗
撞紧	撞紧 ①碰撞②相遇、遇见
散工	散工 零活，或做零活的人
时兴	时兴 正在流行的、时髦的
晒相	晒相 冲洗相片。［词组］
木毒	木毒 寡言少笑，不理睬人
村婆	村婆 乡下妇人（有贬义）
沤水	沤水 长期下雨叫“沤水”
油𧊅	油𧊅 蛙类的一种，多黄色
浪桥	浪桥 浪木荡木，体育器械
滞运	滞运 运气不好。［词组］
焗盅	焗盅 有盖儿的泡茶用的盅
片糖	片糖 长方形块状的土制糖
生米	生米 夹生，大米没煮成饭
痘皮	痘皮 出天花后的疤，麻脸
痰罐	痰罐 痰盂，也叫“痰壶”
着风	着风 ①中风②歇斯底里状
糖仔	糖仔 糖果，各种零吃的糖
糖水	糖水 有汤水的甜品的通称
糠筛	糠筛 筛糠用的小孔的筛子
置家	置家 娶老婆，组织小家庭
肚腩	肚腩 腹部两旁，肋骨下面
自恃	自恃 自行其是，不问就做
臭货	臭货 骂不正经的女人时用
良强	良强 ①能干②项用③霸道
节瓜	节瓜 瓜的一种，比冬瓜小
行家	行家 同行的人或内行的人
衫衩	衫衩 上衣下摆左右的衩口
褪脚	褪脚 光着脚丫，不穿鞋子
谷牛	谷牛 蛘子。又叫“米象”
金塔	金塔 贮存死人骨头的陶器
针紧	针紧 老是，只顾盯住不放
长衫	长衫 民国之前文人的服装
饱卜	饱卜 小孩吃得肚子饱饱的
驶牛	驶牛 农民耕田时常唱的歌
𫐥卯	𫐥卯 无事可做，四处游荡
蛤帽	蛤帽 鸭舌帽，源于英语“cap”
上高	上高 上面，与“下低”相对
卖鸭	卖鸭 隐语，指让老婆偷汉子
发野	发野 怒，发脾气，野性发作
唛头	唛头 ①牌子②样子（鄙称）
土主	土主 庙中的土地神、土地爷
大佬	大佬 ①哥哥②尊称平辈之人
大工	大工 水手的首领、把舵的人
契弟	契弟 ①结拜为兄弟②骂人语
妹仔	妹仔 ①女孩②丫头，即婢女
寄声	寄声 托人口传消息、带口信
废甘	废甘 无用的人，多指青少年
开水	开水 渔船归港时小小的维修
异格	异格 性格与众不同，有贬义
捞笃	捞笃 包抄，绕过后面围起来
斯文	斯文 ①文雅、有礼貌②干净
望口	望口 嘴馋，望着人家吃东西
梗系	梗系 当然是、必定，表肯定
椅贡	椅贡 太师椅之类椅子的扶手
死主	死主 骂人语，意同“死瘟”
死瘟	死瘟 该死的，也说“发瘟”
水帽	水帽 尖顶平边的雨帽、斗笠
泥轿	泥轿 一种体形扁圆的比目鱼
烟筒	烟筒 水烟筒、烟斗、烟嘴儿
爆拆	爆拆 皮肤因冷而龟裂，小皲
爆涓	爆涓 皮肤因冷而龟裂，小皲
百罗	百罗 婴孩出生后的第一百天
百足	百足 蜈蚣。海陵叫“白足”
瞇洋	瞇洋 没神采，办事慢条斯理
破身	破身 处女经过第一次性交后
穿糖	穿糖 事情显露出来（贬义）
篾白	篾白 竹子内部白色制成的蔑
篾青	篾青 竹子外部绿色制成的蔑
脚钏	脚钏 脚腕上的穿戴，装饰品
落力	落力 积极、卖力，做事认真
葭𧊅	葭𧊅 栖息于露兜树的一种蛙
虎毛	虎毛 脸毛（海陵有此说法）
虾辘	虾辘 连壳切成两三段的虾块
蛤蚧	蛤蚧 像蜥蜴的一种四足小蛇
起囊	起囊 被开水烫伤，起了水泡
起水	起水 即“起生”，用于牲畜
酥口	酥口 食品油炸后吃起来很脆
铁蔗	铁蔗 外皮紫红色的一种甘蔗
阴湿	阴湿 暗中用诡计、暗算别人
顶颈	顶颈 与之答辩、回辩、顶嘴
黎话	黎话 电白、水东一带的方言
亏佬	亏佬 血气亏损，身体弱的男子
侉佬	侉佬 说外地话的男人，是鄙称
卯仔	卯仔 坏家伙，但多用于青少年
印仔	印仔 ①大米粉做的糕饼②图章
去归	去归 ①回去、回家②死的代称
发糕	发糕 大米粉发酵后做成的甜糕
吹烟	吹烟 吸（鸦片）、抽（大烟）
唛仔	唛仔 小牛奶罐或小圆铁皮罐子
嘢吃	嘢吃 食品、糕点、零食的总称
地鱼	地鱼 可晒干煮汤的一种比目鱼
堆蔂	堆蔂 计算成堆成群的东西时用
寮仔	寮仔 瞭望或看守庄稼的小草屋
崖鹰	崖鹰 鹰。海陵话又叫“崖婆”
开枱	开枱 ①演戏开幕②饭前摆桌子
戏桥	戏桥 戏剧说明书、戏剧的本事
戳汤	戳汤 把鱼或肉放入开水中制汤
抵吃	抵吃 价钱便宜，合算，值得吃
拜忌	拜忌 在祖先生日、忌日祭祖先
杠仔	杠仔 圆而粗的扛重东西的竹竿
水头	水头 商业用语，指第一手财源
洋漆	洋漆 因接触漆而引起的皮肤病
湴塘	湴塘 已经抽干水的泥潭、泥塘
焗气	焗气 空气不通，使人感到闷气
白撞	白撞 直入屋里乘机偷东西的贼
粘米	粘米 不黏的大米，与糯米相对
糠仔	糠仔 有米皮和小谷壳的一种糠
线公	线公 为匪徒做引导去捉人的人
脚掌	脚掌 脚板，脚丫子靠地的部分
臊鼠	臊鼠 一种肛门能发恶臭的老鼠
色水	色水 ①颜色②显派，自我整饰
虔诚	虔诚 ①斯文，整齐干净②诚心
行行	行行 幼儿学走路，多对幼儿讲
起生	起生 牲畜交配，或发情的迹象
跟尾	跟尾 ①末了，后来②跟在后头
过潮	过潮 不新鲜甚至发臭，多指鱼
铺面	铺面 商店前面陈放商品的地方
镬耳	镬耳 ①锅两边手拿的地方②虹
长气	长气 形容说话说个不停，啰唆
门磌	门磌 门口两块保护门脚的石头
饮茶	饮茶 ①上茶楼喝茶谈心②喝茶
㔹仔	㔹仔 聪明伶俐、办事精灵的小子
丢格	丢格 丢脸，如“其无识丢格个”
亚叔	亚叔 ①父亲的弟弟②代替“爹”
亚婶	亚婶 ①父亲的弟妇②代替“娘”
伴嫁	伴嫁 婚礼期间陪伴新娘的女青年
侉仔	侉仔 说外地话的男青年、男孩儿
咊贺	咊贺 失望或喝倒彩时发出的声音
嚡柴	嚡柴 身心不舒服，心情焦躁不安
四柱	四柱 ①生辰八字②人的四肢骨骼
团峦	团峦 计算圆圆的一大团东西时用
垃圾	垃圾 污物、垃圾，本字“擸𢶍”
大毒	大毒 骂人语，如“你果个大毒”
大话	大话 谎言，如“讲大话”即说谎
山坳	山坳 山冈，两峰之间低陷的地方
快手	快手 手脚快、利索，同“快脆”
拗事	拗事 各执己见，不肯认输的争执
是必	是必 定然、必定、必然，表判断
晚造	晚造 下半年的庄稼是“晚造”的
村仔	村仔 乡下青年或少年（有贬义）
水槽	水槽 农村过涧、架起的输水通道
火鸠	火鸠 一种鸠，比斑鸠小颈无花点
烂仔	烂仔 坏孩子，指爱打闹捣乱的人
犯天	犯天 犯天条，干了不正派的事情
相底	相底 底片、底版、拍摄过的胶片
禾狸	禾狸 体形似猫尾巴似狐的小野兽
禾落	禾落 割稻子时用来挑稻束的竹器
筲箕	筲箕 竹织盛器，圆底，洗米等用
簕竹	簕竹 南方的一种有很多刺的竹子
米筛	米筛 筛子的一种，多用竹篾制成
粪箕	粪箕 担泥、粪、秧苗的竹织器具
粪簏	粪簏 厕所，农家储放大粪的地方
脚屋	脚屋 脚心，脚掌中不着地的部分
装精	装精 自作聪明。又叫“装仔精”
银钱	银钱 元，如“一个银钱”即一元
鱼近	鱼近 库水提鱼时用来装鱼的竹器
鸡簏	鸡簏 养鸡的圈儿，有栏栅围住的
𢫘嘢	𢫘嘢 设法从中获取不正当的利益
𢯭牲	𢯭牲 祭祀祖先用的牺牲中的配搭
衫扣	衫扣 纽扣、扣子。织箦称“衫抽24”
公仔	公仔 ①老头儿②玩具小人儿③人像
冇行	冇行 泛指能得到的财物或利益很少
古凿	古凿 弯着指头用指背敲打别人头部
寄生	寄生 ①寄生在树上的小树②寄居蟹
当家	当家 ①主持家务②主持寺庙的和尚
心焦	心焦 因思念亲人、家乡而坐立不安
打緻	打緻 把布折起来造成的装饰的褶折
晒棚	晒棚 楼房上露天的能晾东西的地方
柜围	柜围 柜台，多指商店、药铺的柜台
樸子	樸子 柚子，僮语也称柚子为“樸”
毫子	毫子 ①银币②一角钱叫“一毫子”
水客	水客 替人带货物，带钱带信的商人
火䆔	火䆔 烤火取暖的随身可提的小炭炉
狂忙	狂忙 形容做事急，慌慌忙忙的样子
缩水	缩水 ①衣物洗过之后变小了②少了
翳蔽	翳蔽 ①心情不开朗②不顺眼、厌恶
老女	老女 旧社会称年岁大而不嫁的女人
肚囊	肚囊 胃里有一点东西叫“有肚囊”
腊蔗	腊蔗 较大的、水分较多的一种甘蔗
膏药	膏药 药膏。当今的软膏不属于膏药
蚁入	蚁入 逐渐侵入、占入，指得寸进尺
蚊激	蚊激 口下有边，盛水防蚁的圆瓦罐
蚝矗	蚝矗 像“矗”字形黏结而生的蚝群
走水	走水 ①避雨②母猪发情时东奔西跑
遭瘟	遭瘟 骂人语，咒人遭受瘟疫而死去
鞠躬	鞠躬 ①行礼的一种②极言“十分”
勒登	勒登 形容为人苛刻，绝不容人的态度
千祈	千祈 千万，如“你千祈无好上树吧”
叶贴	叶贴 糯米面做的甜饼，用菠萝叶作垫
呸蠘	呸蠘 因不吉利事或语句而发的驱邪语
唇舌	唇舌 是非，如“讲唇舌”即搬弄是非
嗦油	嗦油 用嘴吸服油，比喻义为调戏女性
埋泥	埋泥 骂顽童的语言，如“你个埋泥”
大红	大红 行旧式婚礼时女人穿的红色礼服
家志	家志 旧时摸鱼人提的用水草编织的袋
庙背	庙背 没份儿，如“今晚你去庙背吃”
惯势	惯势 助长坏习惯。［固定词组］节俭
拜尚	拜尚 当面吹捧，言过其实，实为贬低
油藤	油藤 ①一种藤②从前一种打人的藤鞭
烟灶	烟灶 厨房用具，指吸油烟机和燃气灶
脚眼	脚眼 脚踝，脚腕两旁凸起骨头的部分
臭馊	臭馊 五谷食物煮好后久放变坏的气味
舅龟	舅龟 鄙称人家“龟孙子”“龟孙儿”
走卷	走卷 考试作弊，把答案卷给别人照抄
走挹	走挹 捉迷藏。与“揞鸡鱼箩仆”近义
趯生	趯生 雄鸡与雌鸡相互追逐调戏、交配
骨子	骨子 精致、幽雅、整齐、恰当、小巧
鱼丸	鱼丸 刮出的鱼肉捣成酱，做成丸子状
鱼腐	鱼腐 将鱼肉刮出捣成酱，做成豆腐状
鱼镬	鱼镬 某些雄鱼的精巢，白色，长条的
先生	先生 ①医生②老师③对知识分子的尊称
大姐	大姐 ①姐姐、闺女的泛称②年轻的姑娘
密实	密实 ①秘密②又浓密又结实③隐藏得好
屋料	屋料 砖瓦木石、水泥、钢筋等建筑材料
庙祝	庙祝 看庙并祝神的人，也叫“庙祝公”
死火	死火 司机语，引申为“动不得”，糟糕
生糁	生糁 多指食品煮得不够火候，缺乏黏性
米头	米头 ①精大米②舂米时剩下舂不净的谷
背税	背税 偏僻或不见太阳、阴暗（的地方）
腻喉	腻喉 腻。食品中油脂过多，使人不想吃
风柜	风柜 手动鼓风使谷子及碎屑分离的农具
鸡头	鸡头 ①繁殖用的公鸡②泛指好色的男子
鸭仔	鸭仔 ①小鸭子②用来指男人（骂人语）
世界	世界 ①生计②话语③同普通话的“世界”
串连	串连 计算一个接一个排成一行的东西时用
刮瘦	刮瘦 吃了缺油的东西的感觉谓之“刮瘦”
收口	收口 ①结束、结尾②疮或伤口缩小、快好
欧流	欧流 皮肤长满了疙瘩，糜烂或形体臃肿态
水糕	水糕 有大米粉加配料和水蒸成的分层的糕
油纸	油纸 油伞，用竹和纸做成，上面抹上桐油
油膉	油膉 即油脂搁得太久变了质所发出的臭味
生空	生空 患麻风症，如“生空佬”“生空婆”
米担	米担 至亲亲戚结婚时送的礼物，用担装着
肫花	肫花 拿禽类的肫切成像花或锯齿似的食品
银宝	银宝 祭祀时烧的一种纸，又称“金银纸”
鱼稿	鱼稿 把鱼刮去肉，剩下带少数肉的皮和骨
布草	布草 布衣服，与“丝发”“皮革”等相对称
心牲	心牲 祭神、祖先的牺牲，是“三牲”之变音
旺月	旺月 商业交易繁忙的月份，和“淡月”相反
照镜	照镜 照壁，就是门口外用来遮挡门口的矮墙
番鸭	番鸭 又叫“香鹑雁”“麝香鸭”“红嘴雁”
竹头	竹头 ①竹之接近根部和根部处②成坡竹之地
败世	败世 不知羞耻、淫秽，如“那个人好败世”
青拉	青拉 蚰蜒、蠼螋，像蜈蚣的小虫，长约一寸
咸神	咸神 色迷迷、不大正经，如“其个人好咸神”
天丑	天丑 雨天、阴天。又，“天丑天”。［词组］
屎畦	屎畦 贮粪便等肥料用的石灰或水泥砌的小池子
煎堆	煎堆 用江米面做的厚皮实心的圆形油炸小点心
回二	回二 分摊物品，分剩部分再分，也叫“回头二”
均是	均是 反正已经，用于话开头，为下面的话做铺垫
烧猪	烧猪 ①食品，烧烤熟的猪②赖死，如“卖烧猪”
煎糍	煎糍 用江米面做的薄皮空心的圆形的油炸大点心
邮票	邮票 邮政机关发行，供寄递邮件贴用的邮资凭证
𫠲顺	𫠲顺 ①通顺（指文章）②驯服、性格温和③顺利
做冬	做冬 冬至时做糕饼、宰鸡鸭祭祖宗，即过冬至节日
崩莎	崩莎 蝴蝶的一种，褐黄色，翅膀大且上有眼形纹样
年庚	年庚 旧式婚礼订婚时写明女方出生年月的红纸礼帖
灶冲	灶冲 在大灶的锅旁开的小洞（利用灶内余火煮水）
街担	街担 代乡村小杂货店往城镇采购货物赚取脚钱的人
锉口	锉口 一种风俗，婴儿满百日第一次吃用猪杂煮的粥
伏嫁	伏嫁 女子嫁前，不与准新郎和客人见面，叫“伏嫁”
埋栏	埋栏 结尾、结局，如“无得埋栏”就是“无法收拾”
油帽	油帽 女人用的帽，像半个球形，戴起来把脸也遮住了
锦肉	锦肉 饼，类似八月十五赏月用的月饼，有豆沙锦肉等
挢扪	挢扪 扪下身的布，男人下水捉鱼、拉网常用它代替裤子
生水	生水 ①食物中茎块类植物不发松的状态②未煮开过的水
粉焙	粉焙 做面条糕饼时用来防止湿面条互相粘连的一点干面
蛋挞	蛋挞 一种甜品，用面粉做皮，装有糊状的鸡蛋的甜点心
潮气	潮气 形容女人有娇气的情态，有巧打扮、卖弄风情的意思
面䍁	面䍁 旧式婚礼，小红绳做成珠帘似的挂在新娘脸上的穿戴
大吉	大吉 ①吉利②旧社会在新年时乞丐沿门卖写着吉利话的红纸
布衫	布衫 布上衣，见《老乞大谚解》：“妈极细皆毛施布衫。”
林累	林累 ①擅长找寻食物，嗜食②钻营利益锱铢必较，无孔不入
淡月	淡月 生意（商业）淡的月份。又，“淡季”指交易少的季节
执菜	执菜 阳江旧俗，女子婚后生子，孩子第一次到母家叫“执菜”
行时	行时 ①吃香，受人欢迎②平时、平日、向来、一向、一贯、一直
早造	早造 稻田收成一年分两造，上半年叫“早造”，下半年叫“晚造”
膀船	膀船 护航的有武装的民船，中华人民共和国成立前防海盗的护航船
钱鸡	钱鸡 用小线串在铜线孔中，用绳拉，使转动，是小孩玩的一种游戏
晏仔	晏仔 饭的别名。旧社会里因“饭”与“犯”同音，就把饭叫“晏仔”
鸡眼	鸡眼 ①穿鞋带的小铁圈②鸡的眼睛③一种足疾，高出皮面的硬结④比喻熬不了夜的人
担枪	担枪 ①两米多长两头削尖用以挑稻草的圆竹。②蚱蜢的一种，头尾都是尖的，因像农具“担枪”而得名
笠衣仔	笠衣仔 T恤
企人边	企人边 亻
石蚬仔	石蚬仔 蛏
丐米佬	丐米佬 乞丐
乞米佬	乞米佬 乞丐
五楞子	五楞子 杨桃
假意趣	假意趣 假装
做鞋佬	做鞋佬 鞋匠
八脚佬	八脚佬 仵作
公仔牌	公仔牌 扑克
冇几久	冇几久 不久
前时人	前时人 前妻
半缆站	半缆站 半途
卡码四	卡码四 ✖️
发筲筋	发筲筋 抽筋
后生仔	后生仔 青年
听闻讲	听闻讲 听说
咸棒唥	咸棒唥 全都
唛仔油	唛仔油 磁漆
唞大气	唞大气 长吁
四块板	四块板 棺材
四面壳	四面壳 面具
外甥孙	外甥孙 外孙
夜晚黑	夜晚黑 晚上
大光灯	大光灯 汽灯
大髻佬	大髻佬 道士
天冷天	天冷天 冷天
天鹅绒	天鹅绒 平绒
头壳顶	头壳顶 头顶
契家佬	契家佬 情夫
契家婆	契家婆 情妇
婆婆娑	婆婆娑 婆娑
寡母婆	寡母婆 寡妇
尼姑婆	尼姑婆 尼姑
屎忽窿	屎忽窿 肛门
屎忽腯	屎忽腯 臀部
屎粪簏	屎粪簏 厕所
师公佬	师公佬 道士
弊屎火	弊屎火 糟糕
懒饭蛇	懒饭蛇 壁虎
打牙较	打牙较 闲扯
打铁佬	打铁佬 铁匠
扫把星	扫把星 彗星
扯白藤	扯白藤 拔河
抹枱布	抹枱布 抹布
斗木佬	斗木佬 木匠
新郎公	新郎公 新郎
无忿得	无忿得 忌妒
无记得	无记得 忘了
时辰钟	时辰钟 时钟
晚间黑	晚间黑 夜晚
朝头早	朝头早 早晨
机器碟	机器碟 唱片
机器针	机器针 唱针
来路货	来路货 洋货
柜拖桶	柜拖桶 抽屉
柜枱桶	柜枱桶 抽屉
棺材佬	棺材佬 仵作
横丫肠	横丫肠 盲肠
水沟埒	水沟埒 水沟
水流鹅	水流鹅 鹈鹕
水爬靓	水爬靓 龙虱
沙罗虫	沙罗虫 蜗牛
烟仔头	烟仔头 烟蒂
煎糍仔	煎糍仔 煎堆
牙较骨	牙较骨 牙骨
牛黄友	牛黄友 无赖
犁晒霜	犁晒霜 犁冬
猪屎喳	猪屎喳 鹊鸲
珍珠粟	珍珠粟 玉米
瓜子树	瓜子树 果树
瓜老趁	瓜老趁 死了
生意佬	生意佬 商人
电胆仔	电胆仔 电珠
番薯树	番薯树 木薯
白话戏	白话戏 话剧
皮头胸	皮头胸 胸口
盲眼佬	盲眼佬 瞎子
看牛仔	看牛仔 牧童
矮瓜丁	矮瓜丁 矮人
矮磨锉	矮磨锉 很矮
硬𪖐𪖐	硬𪖐𪖐 僵直
箩围匝	箩围匝 围墙
粟仔米	粟仔米 小米
线仔绒	线仔绒 哔叽
耙田脑	耙田脑 耘田
背尾婆	背尾婆 后妻
背底奶	背底奶 后母
背底婆	背底婆 后妻
胡子兵	胡子兵 老兵
芥兰头	芥兰头 苤蓝
花口物	花口物 零食
花豆虫	花豆虫 莞菁
花面佬	花面佬 麻子
英文水	英文水 墨水
茶罂仔	茶罂仔 药煲
荷包袋	荷包袋 腰包
菠薐菜	菠薐菜 菠菜
蛤朒仔	蛤朒仔 蝌蚪
裤头带	裤头带 裤带
裤头部	裤头部 腰部
褪脊肋	褪脊肋 裸体
讲大话	讲大话 撒谎
讲虾仔	讲虾仔 多嘴
车大炮	车大炮 吹牛
醉酒佬	醉酒佬 醉汉
铜鼓帽	铜鼓帽 斗笠
问米佬	问米佬 乞丐
问花婆	问花婆 女巫
雷公响	雷公响 雷鸣
雷公打	雷公打 雷击
面脂墩	面脂墩 面颊
顶头风	顶头风 逆风
饭匙骨	饭匙骨 锁骨
饱饱子	饱饱子 略饱
马蹄子	马蹄子 荸荠
马铃薯	马铃薯 土豆
马骝狂	马骝狂 螳螂
鬼钻风	鬼钻风 旋风
鱼头晕	鱼头晕 鱼脑
鱼眼子	鱼眼子 龙眼
麻媚仔	麻媚仔 麻雀
麻雀斑	麻雀斑 雀斑
麻麻子	麻麻子 一般
鼻梁梗	鼻梁梗 鼻梁
鼻轮梗	鼻轮梗 鼻梁
𠵼扭湿	𠵼扭湿 拉痢
䏙䏙圆	䏙䏙圆 溜溜圆
一缗钱	一缗钱 一元钱
一铺路	一铺路 十里路
两仔娘	两仔娘 母子俩
两仔爷	两仔爷 父子俩
两公婆	两公婆 两夫妇
五月节	五月节 端午节
偷阴阴	偷阴阴 偷偷地
公仔书	公仔书 小人书
冇所谓	冇所谓 没关系
剃头佬	剃头佬 理发师
十一贡	十一贡 多指症
卜箕下	卜箕下 金环蛇
卜辘仔	卜辘仔 货郎鼓
发落瘼	发落瘼 荨麻疹
后尾饮	后尾饮 后脑勺
吹筒仔	吹筒仔 小鱿鱼
地豆银	地豆银 花生米
垃圾插	垃圾插 土簸箕
大前日	大前日 大前天
大后日	大后日 大后天
大肚婆	大肚婆 指孕妇
婆栏仔	婆栏仔 小簸箕
尾龙骨	尾龙骨 尾巴骨
影相机	影相机 照相机
戏班佬	戏班佬 做戏的
打烂碟	打烂碟 一种鱼
打锣锤	打锣锤 一种鱼
打麻雀	打麻雀 打麻将
捉仔佬	捉仔佬 人贩子
探米佬	探米佬 男乞丐
探米婆	探米婆 女乞丐
提箩仔	提箩仔 小箩筐
搅马仔	搅马仔 不认真
无识丑	无识丑 不知羞
日记部	日记部 日记本
未臭馟	未臭馟 差得远
水流流	水流流 水汪汪
油流流	油流流 油乎乎
泡打粉	泡打粉 发酵粉
波罗子	波罗子 波罗蜜
洗衫板	洗衫板 洗衣板
流民佬	流民佬 流浪汉
渡仔佬	渡仔佬 即托儿
火柴支	火柴支 火柴棒
火水灯	火水灯 煤油灯
火水炉	火水炉 煤油炉
火爆都	火爆都 气炸了
火船仔	火船仔 小汽船
烧炮仗	烧炮仗 放鞭炮
热水壶	热水壶 热水瓶
照正讲	照正讲 老实说
煲猪肚	煲猪肚 做义务
牙兰豆	牙兰豆 荷兰豆
牙衣衣	牙衣衣 龇牙状
独睡床	独睡床 单人床
猪乸菜	猪乸菜 君达菜
琵琶骨	琵琶骨 肩胛骨
生勾勾	生勾勾 很不熟
生猪瘃	生猪瘃 睑腺炎
生龟佬	生龟佬 驼背的
电单车	电单车 摩托车
电灯杉	电灯杉 电线杆
番桃子	番桃子 番石榴
白灰带	白灰带 小带鱼
百罗雀	百罗雀 百灵鸟
相思仔	相思仔 绣眼儿
眼睛银	眼睛银 眼珠儿
码子筒	码子筒 子弹壳
硬梆梆	硬梆梆 硬得很
神经病	神经病 精神病
笑微微	笑微微 笑嘻嘻
等试辰	等试辰 待会儿
簸箕下	簸箕下 金环蛇
米屎苋	米屎苋 野苋菜
红当当	红当当 红通通
细佬仔	细佬仔 小孩子
细汶仔	细汶仔 小孩儿
翻跟斗	翻跟斗 打跟斗
老伯太	老伯太 老太太
耕田佬	耕田佬 庄稼人
耳疔疮	耳疔疮 中耳炎
耳聋疔	耳聋疔 中耳炎
肥朒朒	肥朒朒 胖乎乎
背窿窿	背窿窿 驼背状
背脊骨	背脊骨 脊椎骨
胡椒粉	胡椒粉 胡椒面
胶箍仔	胶箍仔 橡皮圈
脆筒仔	脆筒仔 小鱿鱼
花子佬	花子佬 二流子
花楞子	花楞子 蕃石榴
落大水	落大水 下大雨
落水仔	落水仔 下小雨
薄页页	薄页页 薄薄的
蚊火仔	蚊火仔 萤火虫
螺丝批	螺丝批 螺丝刀
螺丝拔	螺丝拔 螺丝刀
血流流	血流流 血淋淋
行军床	行军床 帆布床
褂仔鹤	褂仔鹤 蓑衣鹭
豆腐头	豆腐头 豆腐渣
败家仔	败家仔 败家子
败家六	败家六 败家子
趣过翅	趣过翅 很有趣
车衣机	车衣机 缝纫机
辘架床	辘架床 架子床
重林泵	重林泵 重得很
闪闪光	闪闪光 闪闪亮
高踭鞋	高踭鞋 高跟鞋
鬼勾雀	鬼勾雀 猫头鹰
鱼眼鸡	鱼眼鸡 龙眼鸡
鸡仔饼	鸡仔饼 杂烩饼
鸡竹妹	鸡竹妹 童养媳
鸡膥银	鸡膥银 鸡蛋黄
鸡踢椒	鸡踢椒 朝天椒
鸭乸掌	鸭乸掌 扁平足
鹅膥形	鹅膥形 椭圆形
麻桥仔	麻桥仔 江米桥
黄皮头	黄皮头 梅童鱼
黑胶绸	黑胶绸 香云纱
𪥕头巷	𪥕头巷 死胡同
䆔背佬	䆔背佬 驼背的人
二马机	二马机 铜水烟筒
冇彩数	冇彩数 运气不好
冷冷子	冷冷子 有点儿冷
南风螺	南风螺 一种海螺
口水花	口水花 唾沫星子
咸成子	咸成子 有点儿咸
嚡蠄蠄	嚡蠄蠄 很不平滑
外太公	外太公 外曾祖父
天井鸭	天井鸭 孤陋寡闻
天好天	天好天 晴天季节
夫娘婆	夫娘婆 妇人统称
实的的	实的的 硬实得很
家下屋	家下屋 民居家庭
尯脚佬	尯脚佬 跛脚男人
平懒坦	平懒坦 平坦得很
抵腍逋	抵腍逋 非常合算
拜太公	拜太公 拜祭祖先
揩油水	揩油水 捞取便宜
新束束	新束束 新得发亮
新鲜佬	新鲜佬 鲜鱼贩子
无济事	无济事 无济于事
果份样	果份样 这个样子
沙尘友	沙尘友 鲁莽的人
泥水佬	泥水佬 建筑工匠
泥鸡仔	泥鸡仔 泥水小工
浸浸凉	浸浸凉 透心的凉
淡淡子	淡淡子 有点儿淡
湿湿子	湿湿子 有点儿湿
热热子	热热子 有点儿热
猪尿囊	猪尿囊 猪的膀胱
猪肉佬	猪肉佬 贩猪肉的
番鬼佬	番鬼佬 外国男人
番鬼婆	番鬼婆 外国妇女
痛痛子	痛痛子 有点儿痛
白白子	白白子 有点儿白
白鸽眼	白鸽眼 趋炎附势
眼瞇瞇	眼瞇瞇 眯着眼睛
羊屎鹤	羊屎鹤 灰色的鹳
胡镰须	胡镰须 络腮胡子
脷仔落	脷仔落 小舌发炎
臭臭子	臭臭子 有点儿臭
花肚君	花肚君 一种小鱼
苦苦子	苦苦子 有点儿苦
蓝蓝子	蓝蓝子 有点儿蓝
讲大嘴	讲大嘴 闲聊乱扯
邓家仔	邓家仔 疍家男孩
邓家佬	邓家佬 疍家男性
邓家婆	邓家婆 疍家妇女
那份样	那份样 那个样子
酸酸子	酸酸子 有点儿酸
青竹碑	青竹碑 竹叶青蛇
饿饿子	饿饿子 有点儿饿
香香子	香香子 有点儿香
马鲛孙	马鲛孙 小马鲛鱼
高脚佬	高脚佬 长腿男人
鸡屎藤	鸡屎藤 藤科植物
鸡膥螺	鸡膥螺 蚌的一种
黑墨墨	黑墨墨 一片漆黑
黑黑子	黑黑子 有点儿黑
齐辑辑	齐辑辑 排列鏊齐
世界肉	世界肉 最好的东西
丸子包	丸子包 有馅的汤圆
仰靴靴	仰靴靴 仰卧的状态
做田佬	做田佬 农夫、农民
充能械	充能械 显能，逞能
内伤佬	内伤佬 有肺病的人
冇舵船	冇舵船 喻人无主见
发羊吊	发羊吊 癫痫症发作
发鸡盲	发鸡盲 夜盲症发作
口水潺	口水潺 胶状的唾沫
后尾妈	后尾妈 后母、后娘
士曲线	士曲线 自行车辐线
大姐仔	大姐仔 年轻的姑娘
天热天	天热天 热天，夏季
头勾勾	头勾勾 垂头的样子
屎忽尾	屎忽尾 后面，背后
山头髻	山头髻 山顶、山峰
年卅晚	年卅晚 除夕、年底
床脚尾	床脚尾 床尾的后面
手扶仔	手扶仔 手扶拖拉机
捉生公	捉生公 生擒、活捉
捰牙佬	捰牙佬 游走的牙医
揽平头	揽平头 宀，宝盖儿
揾老趁	揾老趁 同“揾笨”
撑船佬	撑船佬 船夫、船工
槽行佬	槽行佬 宰猪卖肉的
江瑶柱	江瑶柱 干贝、肉柱
泡淡水	泡淡水 唆使人松劲
洗身盆	洗身盆 澡盆、浴盆
牙𪘞𪘞	牙𪘞𪘞 龅牙的样子
眼毛长	眼毛长 做事不耐烦
眼爆爆	眼爆爆 凶恶的眼神
眼金金	眼金金 贪婪的眼神
眼𣬬毛	眼𣬬毛 睫毛、眼毛
矮屎䏙	矮屎䏙 矮人、很矮
碌水鼓	碌水鼓 说谎、吹牛
米碎兰	米碎兰 常绿小乔木
红毛泥	红毛泥 水泥、洋灰
羞人丛	羞人丛 丟人、丢脸
翳翳子	翳翳子 有点儿痛心
脚指尾	脚指尾 脚的小拇指
脚马头	脚马头 脚的大拇指
草花头	草花头 艹，草字头
虾膥钻	虾膥钻 比喻人小气
行船佬	行船佬 船夫、船工
订髻奴	订髻奴 白喉红臀鹎
讲小嘴	讲小嘴 说别人坏话
讲牙花	讲牙花 无事聊天儿
闲长时	闲长时 同“闲长”
隔篱屋	隔篱屋 隔壁、邻居
青悲悲	青悲悲 青色的一种
𢯭仔婆	𢯭仔婆 乳母、保姆
事熟证	事熟证 指有人情关系
二八天	二八天 指凉快的季节
做丑人	做丑人 交恶，做冤家
做戏佬	做戏佬 演员、做戏的
冲凉房	冲凉房 洗澡房、浴室
双企人	双企人 双立人“彳”
发膥撬	发膥撬 阴囊病的一种
合桶佬	合桶佬 做盆桶的木工
喂狗蟹	喂狗蟹 女人骂男人语
外江佬	外江佬 外省、外县人
多头纹	多头纹 爱闹事、多事
多头路	多头路 爱闹事、多事
大头狗	大头狗 舞狮的狮子头
夫娘乸	夫娘乸 妇人（憎称）
夫娘仔	夫娘仔 指新婚的妇女
子丑寅	子丑寅 卯，即坏家伙
寡佬索	寡佬索 更凄凉的寡佬
心镊镊	心镊镊 同“心思思”
打雀眼	打雀眼 一只眼不正常
扯唇舌	扯唇舌 说别人的是非
捰柴佬	捰柴佬 樵夫、打柴的
擞发冷	擞发冷 发疟子，疟疾
教师仔	教师仔 教师（贬义）
棉布螆	棉布螆 皮肤病的一种
椰菜仔	椰菜仔 洋白菜的幼苗
榄子核	榄子核 ①橄榄核喉结
点称边	点称边 竖心旁“忄”
眼文文	眼文文 眼睛毫无神色
睏晏觉	睏晏觉 午睡、睡午觉
瞓晏觉	瞓晏觉 午睡、睡午觉
秃统鬼	秃统鬼 挑拨离间的人
笨屎强	笨屎强 屎壳郎、蜣螂
米碎仔	米碎仔 碾碎了的大米
自由女	自由女 不出嫁的女人
荡荡光	荡荡光 形容灯光很亮
萝卜仔	萝卜仔 小萝卜咸萝卜
虾婆弹	虾婆弹 皮皮虾濑尿虾
讲世界	讲世界 谈话、谈家常
财主佬	财主佬 泛指有钱的人
败主狗	败主狗 不护主子的狗
迷迷帝	迷迷帝 昏得不省人事
闲时日	闲时日 同“闲时日”
驮仔乸	驮仔乸 孕妇（鄙称）
鬼打晕	鬼打晕 犯糊涂，骂人
鸡乸菢	鸡乸菢 地老虎的幼虫
鸭膶肠	鸭膶肠 鸭肝制的香肠
𪥕雷槌	𪥕雷槌 钝、很不锋利
㳽㳽基	㳽㳽基 形容很满的样子
七埕酒	七埕酒 阳东县一村委会
亲家嫲	亲家嫲 姻家（指女人）
冇得弹	冇得弹 完美，无可挑剔
双孖仔	双孖仔 双生儿、双胞胎
发凸仔	发凸仔 婴儿扁桃腺发炎
嘴长长	嘴长长 形容爱说长道短
圆眼子	圆眼子 桂圆，热带植物
大工舦	大工舦 舵手，渔民口语
大碌竹	大碌竹 竹子做的水烟筒
大肉桂	大肉桂 胡扯、说谎的人
大茶根	大茶根 有毒的土产植物
天曚曚	天曚曚 将近黎明的时候
嫩粒粒	嫩粒粒 嫩得很、细得很
安生精	安生精 捏造，无中生有
忽必烈	忽必烈 灭宋（𩠌）之人
拗狗屎	拗狗屎 占便宜、不讲理
揼骨佬	揼骨佬 经营按摩的男人
揼骨女	揼骨女 从事按摩的姑娘
搅儿嬉	搅儿嬉 不认真、当儿戏
放白鸽	放白鸽 让妻子与人私通
新出物	新出物 新产品、新东西
无心忿	无心忿 不满意、不甘心
槌角筋	槌角筋 一种有刺的植物
玉荷包	玉荷包 荔枝的一个品种
甜甜子	甜甜子 略甜、有点儿甜
百爷公	百爷公 老爷爷、老头儿
着大激	着大激 横蛮地高声说话
纠丝边	纠丝边 绞丝旁，糸、纟
肥腯腯	肥腯腯 脂肪太多，很腻
臭屎字	臭屎字 笔顺写错了的字
裤头䘿	裤头䘿 半长不短的裤子
走无甩	走无甩 逃不掉、跑不了
跴死蚁	跴死蚁 形容人走路很慢
酸枝木	酸枝木 豆科黃檀属植物
门企星	门企星 门框两旁的竖木
驮膥蟹	驮膥蟹 将要产卵的母蟹
鸡屎疔	鸡屎疔 头上的一种小疮
黄丝蚁	黄丝蚁 一种黄色的小蚁
黑叶仔	黑叶仔 荔枝的一个品种
𠺘口盅	𠺘口盅 漱口盅、茶缸子
二世祖	二世祖 “败家子”的别名
井底蛙	井底蛙 形容见识浅窄的人
光荡荡	光荡荡 亮堂堂、很亮很亮
出头天	出头天 离不幸境遇，出头
出婚婆	出婚婆 夫未死再嫁的妇女
嘴𪖐𪖐	嘴𪖐𪖐 嘴向上翻，不满状
墨鱼船	墨鱼船 墨鱼的骨头，螵蛸
大树脚	大树脚 引申义为“靠山”
头耷耷	头耷耷 失意、沮丧的样子
好人事	好人事 好相处、和蔼可亲
妹仔屎	妹仔屎 小女孩儿（鄙称）
家口船	家口船 以船为家的渔民船
打失茶	打失茶 订婚后死了未婚夫
托大脚	托大脚 巴结有钱有势的人
担仔佬	担仔佬 挑担的男人，挑夫
拖鱼船	拖鱼船 成对拖网捕鱼的船
无相干	无相干 不好不坏，还可以
猪头唛	猪头唛 头大眼小的丑貌人
白肭肭	白肭肭 形容人体肌肤白皙
白鼻佬	白鼻佬 好淫、轻佻的男人
眼反反	眼反反 反眼相看，仇视貌
礼衣边	礼衣边 汉字偏旁，衣字旁
穷佬仔	穷佬仔 穷人，同“穷佬”
薯粉丸	薯粉丸 用薯粉做成的汤丸
蛤仔纸	蛤仔纸 一种玩具枪的火药
补镬佬	补镬佬 以补锅为职业的人
跳皮仔	跳皮仔 顽童、调皮的孩子
雷公笋	雷公笋 半截的、不弯的虹
青头仔	青头仔 处男，未婚的男子
鸡罩攥	鸡罩攥 竹织的没底的鸡笼
黄皮子	黄皮子 热带果名，味酸甜
先时人	先时人 ①前母②死去的丈夫
吃上田	吃上田 吃庆祝“上田”的饭
嘴赠赠	嘴赠赠 形容强辩时嘴的状态
墨墨黑	墨墨黑 形容愚蠢、一窍不通
大拖水	大拖水 咸鱼船洗仓水，鱼露
大碌藕	大碌藕 形容一个人大而无用
大花炮	大花炮 不踏实、爱说谎的人
头崇崇	头崇崇 智商较低，缺乏思想
弊家火	弊家火 糟了，同“弊屎火”
心思思	心思思 惦记在心，希望占有
放放光	放放光 形容浮肿透明的样子
望瞭岭	望瞭岭 阳江江城的一座山名
椰子壳	椰子壳 椰子的坚果皮、外壳
清清形	清清形 冷冷清清，非常沉寂
牛角垌	牛角垌 阳江地区的一条小村
独头佬	独头佬 单身汉（骂人的话）
眼清清	眼清清 恐惧或惊讶时的眼色
禾谷仔	禾谷仔 像禾花雀的一种小鸟
老板婆	老板婆 店主的妻子、女店主
讲唇舌	讲唇舌 搬弄是非、挑拨离间
酸枝椅	酸枝椅 用野荔枝木做的椅子
钓鱼公	钓鱼公 翠鸟，又叫“鱼狗”
雷公狗	雷公狗 蛇的一种，形似蜥蜴
为喉筋	为喉筋 指舌底连下腭的粘连带
之字曲	之字曲 多指道路的连续弯曲处
口水尾	口水尾 仿人家的话，人云亦云
同志仔	同志仔 称呼比自己年轻的干部
嘴尖尖	嘴尖尖 形容牙尖嘴利能说会道
大围罟	大围罟 集体围捕海鱼的一组船
大番薯	大番薯 多指无用的人（贬义）
大粒佬	大粒佬 大人物、有声望的官人
打保头	打保头 代人买东西时中饱私囊
扯索婆	扯索婆 向嫖客介绍暗娼的女人
抛浪头	抛浪头 虚张声势，以言词压人
新学手	新学手 新手，刚掌握技术的人
无通气	无通气 不给人方便，不近人情
死佬碌	死佬碌 骂人语，意同“死瘟”
滑头仔	滑头仔 巧言令色、不实际的人
电灯胆	电灯胆 喻人做事死板，不通气
番菠萝	番菠萝 林檎，学名“番荔枝”
花磌女	花磌女 童养媳婚前死了未婚夫
衫扣公	衫扣公 子母扣子中凸出的一个
阔喇耙	阔喇耙 宽得很（多形容衣物）
雪梨蔗	雪梨蔗 外皮紫红色的一种甘蔗
鸡仔咪	鸡仔咪 鸡皮疙瘩，同“鸡咪”
鸡心椒	鸡心椒 朝天椒，同“鸡踢椒”
丧丧声	丧丧声 打破金属器具发出的声音
做人客	做人客 女子出嫁，即做客的意思
出水鱼	出水鱼 不能留着用（渔民成语）
发肚胀	发肚胀 指急性肠胃炎，肚子胀满
大姐嫂	大姐嫂 俏皮话，称已结婚的姑娘
大桶竹	大桶竹 ①马大哈②指做事不过细
大花厂	大花厂 没有装饰的一种结婚花轿
婆仔粮	婆仔粮 无劳动力的老妇人的口粮
拖唇舌	拖唇舌 惹是生非、背后讲人坏话
拖死蛇	拖死蛇 形容做事拖拖拉拉不积极
搅麦糠	搅麦糠 骚扰、干扰、捣乱、胡闹
污糟猫	污糟猫 指小孩搞得很脏，不卫生
治鼠猫	治鼠猫 不用捉就能威慑住老鼠猫
热呵呵	热呵呵 食物热得不能进口的程度
老举寨	老举寨 妓院，妓女集中住的地方
老公仔	老公仔 ①老头儿②年纪小的丈夫
老婆仔	老婆仔 ①老太太②年纪小的妻子
青光瓮	青光瓮 ①大缸②最大的一种蜻蜓
三八仔	三八仔 不务正业、无志向的年轻人
下路仔	下路仔 指阳江以下，广东西南的人
八卦婆	八卦婆 ①女巫②喜欢搬弄是非的人
半桶水	半桶水 一知半解，无一技之长的人
及第粥	及第粥 猪肝、猪粉肠、瘦肉煮的粥
吃都鬼	吃都鬼 在某事达到目的，占了便宜
哭绥绥	哭绥绥 哭成一把鼻涕一把泪的样子
大头帽	大头帽 用竹篾编制的平边的大雨帽
大心肝	大心肝 ①心狠、不慈善②心狠的人
大耀垌	大耀垌 即平坡大垌，指宽广的田野
拖风鱼	拖风鱼 靠风力行船于大海捕来的鱼
无话得	无话得 ①不能说②很不错，怪不得
月份牌	月份牌 日历。现在多改说“日历”
未交捞	未交捞 远远不及，远远不够，不到
果班嘢	果班嘢 指一群行动不严肃的年轻人
滑捋捋	滑捋捋 滑得很（形容圆滑的东西）
滑脱脱	滑脱脱 滑得很（形容圆滑的东西）
炒鱿鱼	炒鱿鱼 解雇，卷起铺盖像炒鱿鱼状
牛打𢩪	牛打𢩪 粗绳状的麻花，油炸的面食
眼凸凸	眼凸凸 形容眼睛睁得很大，很凶恶
眼吉吉	眼吉吉 对人不满，怒而不言的眼神
老姑婆	老姑婆 老处女，比“老大姐”老些
胡须佬	胡须佬 有髯的人，尤其指络腮胡子
花头鸭	花头鸭 做过坏事为公众所熟知的人
走马蚁	走马蚁 大而黑，走得很快的一种蚁
元胎仔	元胎仔 未婚的青壮年。同“青头仔”
大克屎	大克屎 贬指又大又笨又名声不好的人
大炮友	大炮友 爱吹牛的人，或称“大炮和”
头雷雷	头雷雷 ①走路低头不看人的状态②笨
油麻蔺	油麻蔺 像芝麻的野生植物，可做饮料
眼佐佐	眼佐佐 形容小孩躺着不入睡时的眼色
眼斩斩	眼斩斩 屡教不懂，只见眼皮不断开闭
衫扣乸	衫扣乸 母扣，子母扣子中凹陷的一个
西南天	西南天 刮西南风的天气（渔民用语）
豆腐博	豆腐博 油煎过的小而方的空心的豆腐
贡卡卡	贡卡卡 两臂外张，像螃蟹举螯的状态
金鸡仔	金鸡仔 瓢虫，金红色，像半边小圆珠
顺应喉	顺应喉 答话时没经过思考，随便回答
齐邑邑	齐邑邑 ①排列得整整齐齐②一个不缺
䠥脚鸭	䠥脚鸭 ①断了一只腿的鸭子②一种小船
啮仔佬	啮仔佬 吃小孩的人，用来吓唬小孩的话
墨斗仔	墨斗仔 比墨鱼体小而短的一种软体动物
归公佬	归公佬 海陵一带称修伞、磨刀剪的工匠
楼仔轿	楼仔轿 迎接新妇时用的最美观的大花轿
烂仔头	烂仔头 为首的坏孩子、流氓团伙的头儿
犁头揰	犁头揰 说话或行为冒失，不知轻重的人
猪疬子	猪疬子 寄生在猪肉里的虫子结成的肉粒
索路多	索路多 变化多、花样多、用不着的事多
车仔佬	车仔佬 泛指靠踩自行车搭客赚钱的男子
髻簪螺	髻簪螺 一种长尾螺，壳色白，指头大小
崩口碗	崩口碗 ①有缺口的碗②一种植物，可入药
替面女	替面女 女儿死后，女婿再娶，作为干女儿
望口狗	望口狗 嘴馋，望着人家吃东西（骂人语）
油勒仔	油勒仔 海鱼，扁小，方形，多刺，味鲜美
濑尿虾	濑尿虾 ①虾蛄②引申指遗尿、尿床的小孩
番头婆	番头婆 再婚的妇女，旧时又叫“再醮妇”
眼意意	眼意意 像看太阳时，不能张开眼睛的状态
西门濑	西门濑 ①阳江城一处地名②香港客的谐音
鸡笼掩	鸡笼掩 ①鸡笼的门②喻指西裤的拉链部分
黄芽白	黄芽白 卷心白菜的一种。又名“银芽白”
周身刀	周身刀 全身是刀，讽刺人家所谓“有本领”
扪身布	扪身布 工作时遮在身前的布。又叫“兜肚”
月头婆	月头婆 生孩子后未满一个月的妇人，坐月子
眼光光	眼光光 不能入睡，睁开眼睛往上看时的眼神
鞋挞鱼	鞋挞鱼 ①比日鱼的一种②纸鸢的一种③鞋垫
鸭脚包	鸭脚包 食品，用鸭肠把鸭脚和肥猪肉捆扎好
含笑花	含笑花 一种像玉兰花的香花，别名“香蕉花”
外头人	外头人 ①外地人②还指非本家，包括嫁出之女
大王公	大王公 大王庙里的神。农历三月三日是大王诞
眼矇朦	眼矇朦 眼皮很厚，兼之下垂，看东西看不清楚
眼谷谷	眼谷谷 对事不满又无奈，充满敌对情绪的眼神
贫婆婢	贫婆婢 水田中一种红绿相间的多鳞小鱼，好斗
贫贫屁	贫贫屁 水田中一种红绿相间的多鳞小鱼，好斗
过渡仔	过渡仔 代买东西或代人带东西时取下一些自用
丹桂树	丹桂树 又名“木樨”“桂花”，捩花目、木樨科
剃眼眉	剃眼眉 受到别人有意的讥讽或无稽的嘲弄、侮辱
死仔头	死仔头 死孩子，同“死仔包”。（女人骂男孩语）
死佬头	死佬头 该死的男子，同“死佬”（女人骂男人语）
眼靴靴	眼靴靴 仇视别人时侧视的眼神。书面语为“睨视”
黄钢痴	黄钢痴 黏性很强的胶状物，可以用来粘蝉和捉小鸟
𪥕头婆	𪥕头婆 ①无儿女后代的女人②独身妇女（骂人语）
二四跳	二四跳 形容受虐、受惊吓或极其暴躁时上窜下跳的样子
猪郎公	猪郎公 ①性功能旺盛的淫邪男子②乱搞男女关系的男子
脆缉缉	脆缉缉 很脆。可形容食品的酥脆，也可形容物品不结实
金银引	金银引 食品，用猪肝把长三角形的肥猪肉包起来风干而成
妹仔大	妹仔大 行旧式婚礼时，陪嫁行礼的女孩儿，又叫“伴嫁妹”
碓齿唛	碓齿唛 嵌在粗木一头的圆石墩，与確坎结合，可春米、春粉
番鸭变	番鸭变 两种鸭（番鸭和塘鸭）杂交生下来的一种鸭子，不能繁殖
龙捰水	龙捰水 龙卷风，或指龙卷风把水或风卷成柱状的景象。［词组］
酒糟菜	酒糟菜 困难时期，农村酒席后剩下的吃过的菜肴、汤汁倒在一起，混合后分给亲朋，这种菜叫“酒糟菜”
一时一样	一时一样 多变
吃人骨灰	吃人骨灰 毒辣
天狗吃日	天狗吃日 日食
天狗吃月	天狗吃月 月食
木头公仔	木头公仔 木偶
清清趣趣	清清趣趣 有趣
漏漏就就	漏漏就就 龌龊
白狗争风	白狗争风 吃醋
白面水鸡	白面水鸡 秧鸡
矮屎磨锉	矮屎磨锉 很矮
立立乱乱	立立乱乱 胡乱
褪脚爬蹄	褪脚爬蹄 赤足
无能计得	无能计得 不得已
眼泪流流	眼泪流流 泪汪汪
笑意笑意	笑意笑意 微笑状
老老实实	老老实实 很老实
肉烂采汤	肉烂采汤 没浪费
规规矩矩	规规矩矩 很规矩
黑古窿冬	黑古窿冬 黑得很
黑鬼窿冬	黑鬼窿冬 黑得很
乃流改勃	乃流改勃 到处流浪
大你个钱	大你个钱 以势压人
快快脆脆	快快脆脆 快快儿的
挖肉做疮	挖肉做疮 没事找事
斯斯文文	斯斯文文 文质彬彬
新香旧臭	新香旧臭 贪新厌旧
无声无气	无声无气 不言不语
无情白事	无情白事 无缘无故
淡水长流	淡水长流 细水长流
狂狂忙忙	狂狂忙忙 慌慌忙忙
盲天黑蒂	盲天黑蒂 不明道理
稳稳阵阵	稳稳阵阵 扎扎实实
落水仔溦	落水仔溦 下毛毛雨
落水仔粉	落水仔粉 下毛毛雨
落狗毛水	落狗毛水 下毛毛雨
虾人虾物	虾人虾物 欺负别人
识法犯法	识法犯法 明知故犯
败水皇帝	败水皇帝 垮台皇帝
车天辘地	车天辘地 漫天说谎
颠颠废废	颠颠废废 傻里傻气
𠕳水过镬	𠕳水过镬 转手买卖
个学个样	个学个样 一个学一个
六六局局	六六局局 肚里不舒服
六毫二子	六毫二子 六毛两分钱
头男长女	头男长女 头一胎男女
妹仔人家	妹仔人家 女孩子家家
晒热头黄	晒热头黄 早晨晒太阳
独竹成林	独竹成林 事情会发展
矮屎木笃	矮屎木笃 矮人、很矮
𫣶贼打劫	𫣶贼打劫 趁机做坏事
事事熟熟	事事熟熟 很熟悉，相识
肥头朒耳	肥头朒耳 胖乎乎的样子
伶修俐俐	伶修俐俐 干干净净、聪明
勒时勒刻	勒时勒刻 立刻、限定时刻
揼揼岌岌	揼揼岌岌 摇摇欲坠的状态
摩摩梭梭	摩摩梭梭 做事迟缓动作慢
生生猛猛	生生猛猛 奇奇怪怪或生动
看米下水	看米下水 要注意具体情况
看风驶𢃇	看风驶𢃇 要注意具体情况
睇𩠌食饭	睇𩠌食饭 要注意具体情况
无理无论	无理无论 不计较、大方相处
疏堂兄弟	疏堂兄弟 同支派的如堂兄弟
吽吽窦窦	吽吽窦窦 精神萎靡不振的样子
大早留头	大早留头 大清早，同“大早”
大早留晨	大早留晨 大清早，同“大早”
天公赖屎	天公赖屎 流星下坠。［词组］
死马勒凸	死马勒凸 呆呆地站着一动不动
留命等运	留命等运 拖延时间，等待时机
累人累物	累人累物 即“害人害物”之意
胡须勒凸	胡须勒凸 脸上胡子拉碴的样子
融融末末	融融末末 成酱状、糊状、粉状
今生今世	今生今世 此生此世，指有生之年
米煮成饭	米煮成饭 成了定局，改变也晚了
黐手黐脚	黐手黐脚 粘得很，多指小孩缠人
一口系脷	一口系脷 满口是舌头，意即说不清
戆婆等轿	戆婆等轿 傻等、喻做事不会动脑筋
栏头过耳	栏头过耳 不管青红皂白，乱干一通
火烧火濑	火烧火濑 热不可当或皮肤痛不可当
六月落霜	六月落霜 意想不到的灾难，心中懊丧
疏过落北	疏过落北 对做过的事不满意，很后悔
三姑六婆	三姑六婆 爱管闲事或职业不正当的妇女
男人大丈	男人大丈 堂堂男子汉。（常用于贬称）
蛇头鼠眼	蛇头鼠眼 形容人的面相丑恶，心术不正
水过鸭背	水过鸭背 比喻事过之后没有留下一点痕迹
一听二望	一听二望 较长时间、耐心地、充满希望地等待
尖头利角	尖头利角 连小事也不放松。无孔不入，一点小利都不放过
摸摸挱挱	摸摸挱挱 ①做事迟缓动作慢②往眼睛看不到的地方摸来摸去
地理先生	地理先生 堪舆家，旧社会靠迷信为生的一种人，也叫“地理佬”
大吉利是	大吉利是 小孩或妇女打喷嚏时，妇女接着说一句“大吉利是”表示吉利
吃狗无持毛	吃狗无持毛 厉害
杀人无眨眼	杀人无眨眼 凶残
窿背佬下坎	窿背佬下坎 顺势
木头公仔戏	木头公仔戏 木偶戏
米筛遮大伯	米筛遮大伯 不顶事
二一添作五	二一添作五 平均分开
危险过剃头	危险过剃头 非常危险
夹估买老牛	夹估买老牛 不算细账
杀人无使刀	杀人无使刀 手段厉害
狗死狗虱亡	狗死狗虱亡 同归于尽
老鼠记谷种	老鼠记谷种 念念不忘
补被补紧席	补被补紧席 顾此失彼
讲笑讲成真	讲笑讲成真 弄假成真
阉鸡阉出肠	阉鸡阉出肠 技术不精
马屎𫣶官威	马屎𫣶官威 恃势欺人
便宜冇好嘢	便宜冇好嘢 便宜没好货
知死无瞇眼	知死无瞇眼 事先不了解
无死甩层皮	无死甩层皮 比喻十分厉害
偷都太爷银	偷都太爷银 做错事，很害怕
冇手安出脚	冇手安出脚 搬弄是非，造谣
好心无用斋	好心无用斋 不必装作好心人
想快无得撚	想快无得撚 形容想快快不来
人情紧过债	人情紧过债 送人情比还债还紧
出世遇黄巢	出世遇黄巢 生不逢时，逢乱世
故意踏差鞋	故意踏差鞋 有意为难或有意做错
无声狗咬人	无声狗咬人 寡言的人也有阴险的
雷公打豆腐	雷公打豆腐 不是敌手，所向无敌
鲎壳𠕳无起	鲎壳𠕳无起 即“烂泥糊不上墙”
冇窿挖出蛤	冇窿挖出蛤 即无事生非，善于做作
冇隆扲出鳝	冇隆扲出鳝 即无事生非，善于做作
打死狗讲价	打死狗讲价 事前不商量，无可挽回
本地姜无辣	本地姜无辣 看不起本地人，本地货
看鬼无出相	看鬼无出相 意料不到，表里不一致
揞鸡鱼箩仆	揞鸡鱼箩仆 提迷藏，北京话为“藏猫猫”
周身卜碌刀	周身卜碌刀 比喻身手不凡，但多用于讥讽人
赶狗入穷巷	赶狗入穷巷 即事情做得太绝，到头来遭报复
一肚心无落	一肚心无落 对结果非常不满，或对事情非常担心
二八乱穿衣	二八乱穿衣 “二八”指阳江的农历二月八月天气
芋呷作蛇打	芋呷作蛇打 看不清，做错事。“芋呷”即芋头叶柄
无打得眼甩	无打得眼甩 形容物小或价值不高，不能引起对方重视
死过虾㑷曲	死过虾㑷曲 意同上。形容事情糟透了。“能”即那样
买炮仗请人放	买炮仗请人放 笨
冇狗押猫吃屎	冇狗押猫吃屎 将就
一粒米都爆罂	一粒米都爆罂 有就吃
上得高跌得重	上得高跌得重 位高者危
有你讲冇倩话	有你讲冇倩话 专横霸道
棺材也要锯角	棺材也要锯角 贪财至极
画公仔画出肠	画公仔画出肠 多此一举
番鬼佬屎都香	番鬼佬屎都香 媚外之言
炮仗一点就着	炮仗一点就着 比喻性子急
看见都黄鳝尾	看见都黄鳝尾 事情略见头绪
知死华肯闭眼	知死华肯闭眼 无法预料后果
张天师着鬼迷	张天师着鬼迷 聪明反被聪明误
一停货一停钱	一停货一停钱 一种货物一种价钱
冇油无得脱镬	冇油无得脱镬 不花钱就成不了事
上床又想冚被	上床又想冚被 得寸进尺，贪得无厌
卖麻糖舐巴掌	卖麻糖舐巴掌 意同“种稻的人没米吃”
隔离屋饭焦香	隔离屋饭焦香 邻家的锅巴香，意即人家的东西比自己的好
龙床无敌狗窦	龙床无敌狗窦 人家的好床也难以入睡，比喻不习惯于新环境
头路多过磨柱花	头路多过磨柱花 多事
年晚钱，饭后烟	年晚钱，饭后烟 急需
手指拗入无拗出	手指拗入无拗出 偏私
一个麻雀分千兵	一个麻雀分千兵 分不了
一分钱，一分货	一分钱，一分货 价值相当
一尺风，三尺浪	一尺风，三尺浪 推波助澜
买炮仗放灶愿烧	买炮仗放灶愿烧 用非其所
外低好看里头空	外低好看里头空 华而不实
屙屎无出怨地硬	屙屎无出怨地硬 胡乱埋怨
山鸡走入凤凰群	山鸡走入凤凰群 鱼目混珠
篾白杀人无用刀	篾白杀人无用刀 手段厉害
肥水无落别人田	肥水无落别人田 自己得利
芋呷水，两头流	芋呷水，两头流 挑拨是非
辰时开花卯时戴	辰时开花卯时戴 急于求成
顺得哥来失嫂意	顺得哥来失嫂意 左右为难
一人无敌两人计	一人无敌两人计 人多计谋多
一粒米也爱做饭	一粒米也爱做饭 有就吃掉它
好牛无吃回头草	好牛无吃回头草 要勇往直前
田螺无知身呢扭	田螺无知身呢扭 无自知之明
真金无怕红炉火	真金无怕红炉火 经得起考验
讲来讲去三幅被	讲来讲去三幅被 啰唆、重复
头上无花花屎𡱽	头上无花花屎𡱽 装饰错了地方
好心无得好来报	好心无得好来报 好心不得好报
好猪仔无阉得坏	好猪仔无阉得坏 真金不怕火炼
屙屎落衭一时松	屙屎落衭一时松 贪图一时方便
由曱无知身臭臊	由曱无知身臭臊 没有自知之明
老虎头上钉虱乸	老虎头上钉虱乸 太岁头上动士
十个指头有长短	十个指头有长短 做事不能一刀切
大沟米，一身沙	大沟米，一身沙 充阔，无自知之明
有钱使得鬼推磨	有钱使得鬼推磨 讽刺见钱眼开的人
老鼠想吃天鹅肉	老鼠想吃天鹅肉 癞蛤蟆想吃天鹅肉
送芋之人思月饼	送芋之人思月饼 抛砖引玉。有贬义
一下生，两下熟	一下生，两下熟 见得多，自然会熟识
一日生，两日熟	一日生，两日熟 多见面就会互相熟悉
一鸡衰，百鸡锥	一鸡衰，百鸡锥 比喻一人倒霉众人欺
万丈高楼凭地起	万丈高楼凭地起 按部就班，先打基础
四两鸭仔探条颈	四两鸭仔探条颈 能力不大，却不示弱
灶愿面前执大刀	灶愿面前执大刀 岂有此理、不合情理
床头打跤床尾和	床头打跤床尾和 夫妻吵架容易互相谅解
一样米吃百样人	一样米吃百样人 人是复杂的，多种多样的
盲眼佬生盲眼仔	盲眼佬生盲眼仔 无开之日，多指久雨不晴
鸡腿打人牙较软	鸡腿打人牙较软 吃人的口软，拿人的手软
偷鸡无紧蚀把米	偷鸡无紧蚀把米 做坏事不成功，反而受亏损
有风无好尽驶𢃇	有风无好尽驶𢃇 事情不要做绝，要留有余地
一家点火两家光	一家点火两家光 一举两得，将孩子过继给亲戚
阉鸡无紧去阉猫	阉鸡无紧去阉猫 甲事做不成去做乙事，胡乱来
无委讲至出厅底	无委讲至出厅底 骂人语。责备人说错话的恶毒语
瘦狗无忍得热屎	瘦狗无忍得热屎 耐不住引诱，也喻没有耐心等待
阿太生仔使人教	阿太生仔使人教 比喻多此一举，或讥人好为人师
一山华有一山高	一山华有一山高 一山更比一山高。“华”即“还”
屎𡱽花花计话人	屎𡱽花花计话人 自己的丑事多着呢，还去评论别人
鸡膥㑷密菢出仔	鸡膥㑷密菢出仔 意即“欲使人不知，除非已莫为”
死过咸鱼曲过虾	死过咸鱼曲过虾 形容人把事情办坏了，落得不可收拾的境地
𧨾人上树拔都梯	𧨾人上树拔都梯 骗人家上树然后把上树的梯子移走，即有意为难
拆观音堂起关帝庙	拆观音堂起关帝庙 顾此失彼
一个钱绹十二个克	一个钱绹十二个克 吝啬、节俭
性急无吃得热蕃薯	性急无吃得热蕃薯 欲速则不达
拐仔过门槛都要钱	拐仔过门槛都要钱 千点小事也要报酬
撑得船来无打得鼓	撑得船来无打得鼓 分身不下，事不可兼为，顾此失彼
捰得上安无得下落	捰得上安无得下落 哄得了长辈却得罪了晚辈，即顾此失彼
大姨生疮，捉二姨灸	大姨生疮，捉二姨灸 乱做
白狗偷吃，黑狗担灾	白狗偷吃，黑狗担灾 冤枉
一个半斤，一个八两	一个半斤，一个八两 不相上下
上无到洲，下无到岸	上无到洲，下无到岸 进退为难
入乡从俗，入水从湾	入乡从俗，入水从湾 适应环境
公不离婆，秤不离砣	公不离婆，秤不离砣 不能分开
吃多屙多，搞多错多	吃多屙多，搞多错多 多做多错
带衣无寒，带米无饥	带衣无寒，带米无饥 有备无患
臭猪头碰紧饿鬼菩萨	臭猪头碰紧饿鬼菩萨 各有所好
牛着牛当，马着马亡	牛着牛当，马着马亡 不互相帮助
打铜吃铜，打铁吃铁	打铜吃铜，打铁吃铁 做什么吃什么
有㑷大头，顶㑷大帽	有㑷大头，顶㑷大帽 意即量力而为
有心生膥，冇心菢仔	有心生膥，冇心菢仔 做事有头无尾
耳听为闻，眼见为真	耳听为闻，眼见为真 必须亲自实践
一子错，满盘皆落索	一子错，满盘皆落索 错一步，步步错
大人𨆓墙，细仔学样	大人𨆓墙，细仔学样 大人做了坏榜样
翻转系锣，覆转系鼓	翻转系锣，覆转系鼓 多变、反复无常
一粒米做无出一镬饭	一粒米做无出一镬饭 巧妇难为无米之炊
做船起屋，一两两六	做船起屋，一两两六 做计划要留有余地
上无到天，下无到地	上无到天，下无到地 前不着村，后不着店
迟田莫耕，迟仔莫生	迟田莫耕，迟仔莫生 不合时宜的事不要做
有清吃清，有浊吃浊	有清吃清，有浊吃浊 能同甘共苦或不拘饮食
有粥吃粥，有饭吃饭	有粥吃粥，有饭吃饭 能同甘共苦或不拘饮食
麻雾谷谷，大鱼入屋	麻雾谷谷，大鱼入屋 大雾天捉鱼多——渔谚
牛事未了，马事又来	牛事未了，马事又来 事件接踵而来，多指坏事
亲了关帝，得罪了观音	亲了关帝，得罪了观音 顾此失彼
手掌系肉，手背也系肉	手掌系肉，手背也系肉 左右为难
扭一个计，拧又一个计	扭一个计，拧又一个计 反复无常
人矮心高，杀人无使刀	人矮心高，杀人无使刀 贪心、心坏
无在起身早，尽在粥冻	无在起身早，尽在粥冻 赶早不如赶巧
未吃三日豆腐，想升仙	未吃三日豆腐，想升仙 功夫未到家，想逞能
未到棺材头，眼泪无流	未到棺材头，眼泪无流 不到紧要关头无动于衷
在家千日好，出路半朝难	在家千日好，出路半朝难 
独木不成林，独仔无人群	独木不成林，独仔无人群 
住在茅寮下，势着放低头	住在茅寮下，势着放低头 被迫顺从
木门对木门，竹门对竹门	木门对木门，竹门对竹门 门第相当
点火生亚大，打锣嫁亚奶	点火生亚大，打锣嫁亚奶 做事颠倒
见高低头拜，见低屙尿濑	见高低头拜，见低屙尿濑 欺善怕恶
青竹蛇儿口，黄蜂尾后针	青竹蛇儿口，黄蜂尾后针 形容人恶毒
黄鳝过沙滩，无死脱身潺	黄鳝过沙滩，无死脱身潺 喻事情棘手
上屋搬下屋，冇见一箩谷	上屋搬下屋，冇见一箩谷 损耗是难免的
懒人多计轿，无系屎至尿	懒人多计轿，无系屎至尿 懒惰的人借口多
无怕无识货，至怕货比货	无怕无识货，至怕货比货 “至怕”即最怕
男大映门风，女大羞人丛	男大映门风，女大羞人丛 催成年男女婚嫁
瘦狗攀高栈，无攀好过攀	瘦狗攀高栈，无攀好过攀 不应有非分的妄求
有被也天光，无被也天光	有被也天光，无被也天光 贫富都一样要过日子
行得夜路多，终归撞紧鬼	行得夜路多，终归撞紧鬼 多做坏事，总会受惩罚
人情为人情，数目爱分明	人情为人情，数目爱分明 私事归私事，账目不能糊涂
无到棺材头，眼泪未肯流	无到棺材头，眼泪未肯流 事情不到很糟糕时还不服输
盲眼佬钉竻，有开眼佬挑	盲眼佬钉竻，有开眼佬挑 不要以为人家可欺，提防有人替他出气
千世无抬轿，抬轿撞紧亲家	千世无抬轿，抬轿撞紧亲家 比喻刚做事就丢脸
打死一世蛤仔，无到一罂煲	打死一世蛤仔，无到一罂煲 干一辈子也无济于事
你有㑷深水，俼有㑷长竹篙	你有㑷深水，俼有㑷长竹篙 不要以为自己了不起，人家不会比你差
你无嫌我箩疏，我无嫌你米碎	你无嫌我箩疏，我无嫌你米碎 互不嫌弃
系那谷出那米，系那娘出那仔	系那谷出那米，系那娘出那仔 事出有因
一代姑，二代表，三代了了了	一代姑，二代表，三代了了了 亲戚三代之后，便无亲可言
朝红风，晚红雨，晏昼红街市	朝红风，晚红雨，晏昼红街市 早晨天红是打风的预兆，晚上红是下雨的预兆
算命先生不知死，地理先生无处埋	算命先生不知死，地理先生无处埋 骗人
交疍家，养鸭乸，你一揸，其一把	交疍家，养鸭乸，你一揸，其一把 礼尚往来
好马不吃回头草，好女无嫁回头佬	好马不吃回头草，好女无嫁回头佬 要勇往直前
大刀无磨成死铁，夫娘无打成妖孽	大刀无磨成死铁，夫娘无打成妖孽 对老婆要多教训
行船跑马三分命，生仔夫娘冇一成	行船跑马三分命，生仔夫娘冇一成 喻产妇临产的危险
跟得好人得好话，跟得丑人执教化	跟得好人得好话，跟得丑人执教化 近朱者赤，近墨者黑
卖扇夫娘手遮月，卖花夫娘插竹叶	卖扇夫娘手遮月，卖花夫娘插竹叶 意同“种稻的人没米吃”
嫁鸡随鸡，嫁狗随狗，嫁着马骝浑山走	嫁鸡随鸡，嫁狗随狗，嫁着马骝浑山走 随遇而安
